State,County,Returns Total,Total AGI,Outflow,Outflow AGI,Inflow,Inflow AGI,Net Inflow(Outflow),Percentage Flow
NV,Eureka County,556,38167,26,2961,78,4974,52,9.353
NE,Hooker County,279,10670,-1,-1,21,874,22,7.885
ND,McKenzie County,3461,464151,575,46125,837,52025,262,7.57
CO,Mineral County,324,21265,-1,-1,22,1256,23,7.099
ND,Williams County,12437,1217462,1644,112302,2504,137024,860,6.915
NC,Brunswick County,47066,3211054,3326,175906,6105,530642,2779,5.904
TX,Comal County,49749,4841034,5072,343378,7990,643962,2918,5.865
TX,Kaufman County,40842,2771282,4100,223030,6450,352451,2350,5.754
FL,Sumter County,48310,3902622,3477,206987,6242,532865,2765,5.723
NV,Nye County,14356,776985,1233,58992,2032,112840,799,5.566
MT,Madison County,3099,194265,235,11423,404,32544,169,5.453
SD,Hyde County,518,26382,-1,-1,27,964,28,5.405
ID,Valley County,4068,288217,386,19540,605,47871,219,5.383
NV,Storey County,1489,103314,161,7260,240,20234,79,5.306
ID,Adams County,1405,69954,124,6432,194,10723,70,4.982
GA,Union County,8034,442940,543,26117,942,61492,399,4.966
NV,Esmeralda County,283,14434,26,956,40,1816,14,4.947
FL,Walton County,22754,2439457,2366,234757,3451,469223,1085,4.768
MT,Liberty County,765,33614,-1,-1,34,604,35,4.575
SD,Harding County,503,32179,-1,-1,22,699,23,4.573
TX,Kendall County,15826,2123389,1514,131897,2222,281173,708,4.474
NV,Lyon County,19652,1035138,2048,101840,2926,146612,878,4.468
CO,Huerfano County,2032,93385,203,8365,293,14498,90,4.429
AZ,Pinal County,111736,6261375,11620,619118,16547,911743,4927,4.41
CO,Ouray County,1906,143792,199,18002,281,25546,82,4.302
FL,St. Johns County,85850,10002422,7264,586256,10940,1127904,3676,4.282
OR,Crook County,7826,467038,652,28981,987,59271,335,4.281
CO,Park County,5762,415822,723,44826,968,66086,245,4.252
GA,Jackson County,21694,1424906,2143,112575,3046,176523,903,4.162
SC,Jasper County,8324,409293,920,42217,1265,71439,345,4.145
CO,Archuleta County,4862,298637,421,24108,621,55898,200,4.114
ID,Boise County,2482,160757,289,17172,391,31172,102,4.11
FL,Nassau County,30775,2618023,2430,142458,3695,364006,1265,4.11
VA,New Kent County,8321,863822,695,55973,1035,100182,340,4.086
FL,Lake County,125505,7498308,11203,535280,16295,956851,5092,4.057
WA,San Juan County,7114,840706,424,34588,711,88649,287,4.034
TX,Williamson County,187709,16999940,18788,1244948,26347,1818808,7559,4.027
TX,Blanco County,4070,335384,312,13270,474,49058,162,3.98
GA,Towns County,4076,234404,306,13896,466,27137,160,3.925
TX,Dickens County,561,30486,27,761,49,2635,22,3.922
CO,Sedgwick County,817,34667,30,1328,62,2056,32,3.917
NE,Boyd County,723,26263,-1,-1,27,972,28,3.873
TX,Parker County,45008,4043769,4236,329294,5958,459363,1722,3.826
TX,Hood County,19870,1603958,1845,111358,2599,202335,754,3.795
UT,Kane County,2376,136576,203,8114,293,14302,90,3.788
GA,Barrow County,25014,1474801,2535,123286,3475,179230,940,3.758
VA,Goochland County,8701,1401366,652,74983,978,108483,326,3.747
UT,Rich County,704,39812,31,1923,57,2927,26,3.693
CO,Lake County,2501,139652,343,14637,435,19875,92,3.679
NE,Deuel County,657,36640,34,1662,58,1865,24,3.653
FL,Charlotte County,65851,4186426,5791,300628,8144,614629,2353,3.573
NC,Cherokee County,9018,415273,580,25240,897,48265,317,3.515
TX,Polk County,17663,1046550,2132,133235,2750,210761,618,3.499
NC,Johnston County,63794,4123749,4835,247415,7050,381173,2215,3.472
ID,Butte County,778,39618,44,3157,71,3386,27,3.47
TX,Andrews County,5410,478686,370,22013,557,33104,187,3.457
WA,Pacific County,7784,434399,583,24817,852,45927,269,3.456
SD,Lincoln County,20899,2430125,2419,172261,3140,212390,721,3.45
NC,Franklin County,20816,1190082,1728,84668,2442,128762,714,3.43
IA,Dallas County,30754,3635281,3617,278590,4672,335788,1055,3.43
MT,Broadwater County,2072,119905,158,8557,229,11936,71,3.427
SC,Lancaster County,30807,2033727,2155,170842,3205,231016,1050,3.408
ID,Gem County,5825,291389,514,22017,712,41480,198,3.399
TX,Llano County,6822,553752,703,53465,934,89413,231,3.386
TX,Rains County,3428,192209,333,14065,449,29296,116,3.384
FL,Santa Rosa County,57698,4196080,5873,331031,7819,473388,1946,3.373
CO,Chaffee County,7289,493000,648,32864,892,63657,244,3.348
ID,Teton County,3670,247011,378,20847,500,37411,122,3.324
FL,Pasco County,176843,10628235,16437,899758,22300,1256779,5863,3.315
GA,Long County,3655,164980,837,30462,958,34316,121,3.311
AR,Fulton County,3418,145742,239,7263,352,13347,113,3.306
AZ,Mohave County,63714,3107995,4993,209302,7087,408188,2094,3.287
CO,Crowley County,854,34986,58,1663,86,3070,28,3.279
FL,Citrus County,52220,2769914,3760,176255,5471,319564,1711,3.277
GA,Effingham County,18898,1254113,1694,82115,2313,124805,619,3.275
UT,Wayne County,825,43607,47,2083,74,4084,27,3.273
TX,Liberty County,23725,1482670,2153,95849,2929,135394,776,3.271
GA,Greene County,6093,645643,428,44530,627,105277,199,3.266
CO,Saguache County,1471,56314,189,6763,237,9174,48,3.263
UT,Washington County,51242,3581771,4044,196069,5703,423214,1659,3.238
SC,Horry County,120829,6647894,8588,391452,12491,825602,3903,3.23
ID,Canyon County,66550,3591204,5521,246231,7635,368984,2114,3.177
WA,Columbia County,1355,79860,78,4057,121,6221,43,3.173
AL,Limestone County,30768,2193176,2125,140568,3100,201811,975,3.169
FL,Hernando County,63180,3133865,5202,217213,7203,339444,2001,3.167
GA,Fannin County,8231,449342,533,27304,793,62320,260,3.159
DE,Sussex County,86538,6020015,4318,233772,7045,611792,2727,3.151
AZ,Yavapai County,84339,5047686,5957,303569,8607,606970,2650,3.142
TN,Johnson County,5072,234632,182,7661,341,18439,159,3.135
TX,Ellis County,58789,4375093,4540,259216,6382,414013,1842,3.133
GA,Dawson County,7642,561388,873,44937,1112,75585,239,3.127
OR,Deschutes County,71440,5811951,5355,345001,7585,662369,2230,3.122
CO,Gilpin County,2091,146146,276,17000,341,24651,65,3.109
UT,Iron County,14152,806290,1338,52121,1775,85495,437,3.088
NC,Pamlico County,4261,252148,249,11295,380,24492,131,3.074
TX,Bandera County,7535,493821,630,31284,860,61838,230,3.052
TX,Rockwall County,31246,3703952,3566,264880,4519,376133,953,3.05
KY,Bracken County,2894,147754,127,4276,215,8072,88,3.041
CO,Custer County,1648,105742,195,8278,245,19105,50,3.034
WA,Jefferson County,13277,986808,943,55466,1345,98602,402,3.028
GA,Paulding County,49626,3264173,5260,269783,6759,337299,1499,3.021
FL,Flagler County,40791,2667645,3468,165139,4698,353956,1230,3.015
FL,Gilchrist County,5010,262981,460,16637,611,25273,151,3.014
VA,Louisa County,12921,866165,983,58237,1372,87020,389,3.011
AL,Baldwin County,73765,5421048,4609,238893,6818,491043,2209,2.995
UT,Wasatch County,9536,929037,1014,64681,1299,149296,285,2.989
GA,Butts County,6975,398817,595,25455,803,37249,208,2.982
SD,Fall River County,2618,139073,213,8588,291,12259,78,2.979
FL,Wakulla County,10191,590440,738,34833,1041,49495,303,2.973
WA,Mason County,21507,1369055,1813,94154,2448,144936,635,2.953
TX,Reeves County,3713,300243,271,29745,380,18365,109,2.936
NC,Lincoln County,28565,2088459,2070,125002,2908,216957,838,2.934
TX,Montgomery County,181177,19602627,15896,1295890,21194,1792445,5298,2.924
MT,Sweet Grass County,1339,79369,61,3180,100,4629,39,2.913
GA,Bryan County,11921,916911,1832,109897,2174,130675,342,2.869
TX,Wise County,21307,1497342,1829,105513,2433,160097,604,2.835
NC,Chatham County,26521,2565638,2051,146152,2801,289014,750,2.828
SC,York County,91602,7200880,6320,378879,8907,658227,2587,2.824
TX,Wood County,14368,862826,1177,55656,1582,84373,405,2.819
TX,Waller County,14338,1002214,1624,87181,2028,144646,404,2.818
GA,Forsyth County,72597,8778654,6638,637957,8683,795579,2045,2.817
CO,Weld County,100674,7811951,8860,520398,11695,729652,2835,2.816
SD,Clark County,1353,77377,53,2709,91,4706,38,2.809
TN,Montgomery County,63354,3491904,8890,389305,10659,448801,1769,2.792
TN,Marshall County,11524,630949,779,34410,1098,52821,319,2.768
TX,Irion County,542,58903,41,1968,56,2693,15,2.768
OR,Lincoln County,17247,997450,1571,78133,2046,112013,475,2.754
FL,Polk County,229155,12424728,16582,708094,22888,1049764,6306,2.752
CO,Bent County,1201,52524,70,2161,103,3635,33,2.748
TN,Maury County,33569,2042068,2941,149879,3860,221548,919,2.738
WA,Wahkiakum County,1474,88968,98,4293,138,7042,40,2.714
OR,Curry County,8267,451318,709,40423,932,50851,223,2.697
FL,Marion County,125217,6481680,8384,355566,11747,599119,3363,2.686
NC,Harnett County,37386,2048732,4916,231513,5920,275460,1004,2.685
FL,Indian River County,59008,6043223,4170,254578,5750,707436,1580,2.678
TN,Cumberland County,21460,1118663,1285,55725,1857,112323,572,2.665
OK,Canadian County,46456,3571507,4260,246357,5495,310300,1235,2.658
CO,Douglas County,115898,16401047,12989,1438525,16067,1541931,3078,2.656
FL,Franklin County,3426,219195,209,16997,300,21491,91,2.656
GA,Pickens County,11270,765698,903,51304,1202,97985,299,2.653
TX,Bastrop County,27477,1675113,2414,118449,3139,156229,725,2.639
ID,Oneida County,1403,70808,91,3030,128,6233,37,2.637
FL,Washington County,6943,326528,650,22441,833,33024,183,2.636
TX,Hudspeth County,1561,69513,194,8958,235,9444,41,2.627
GA,Gilmer County,9589,522005,701,33098,952,53248,251,2.618
SC,McCormick County,3095,175602,205,10988,286,19527,81,2.617
TN,Wilson County,49158,3984963,4210,252522,5494,360420,1284,2.612
ID,Bonner County,15824,996399,1231,64085,1642,112893,411,2.597
FL,St. Lucie County,111202,6173509,8916,413174,11797,704139,2881,2.591
GA,Cherokee County,83406,7289210,7334,465692,9493,664321,2159,2.589
FL,Manatee County,137026,10802578,11227,638817,14773,1252276,3546,2.588
CO,Baca County,1205,39482,32,574,63,2354,31,2.573
FL,Sarasota County,163058,15473920,12770,806970,16961,1884404,4191,2.57
OK,Marshall County,4718,239015,329,13186,449,20877,120,2.543
ID,Kootenai County,58832,3885797,3857,188472,5349,377234,1492,2.536
TX,Hunt County,29303,1721204,2690,123296,3432,173862,742,2.532
FL,Dixie County,3833,158828,281,9659,378,13557,97,2.531
OK,Pushmataha County,3123,138530,195,7085,274,10383,79,2.53
VT,Grand Isle County,3046,244679,266,17800,343,27194,77,2.528
WA,Klickitat County,7879,591239,581,33045,780,55678,199,2.526
VA,Richmond County,2776,154696,192,7054,262,12344,70,2.522
WV,Berkeley County,42602,2536510,2930,143221,4004,199336,1074,2.521
MO,Lincoln County,19947,1212458,1382,66163,1883,95398,501,2.512
KY,Robertson County,678,29942,36,1439,53,1988,17,2.507
WI,Adams County,7462,373705,571,23087,758,39089,187,2.506
TX,Sabine County,3252,180782,237,11268,318,19903,81,2.491
MT,Ravalli County,15765,968671,1123,57236,1514,107821,391,2.48
ID,Ada County,165117,13939220,11418,631146,15509,1088360,4091,2.478
TX,Chambers County,13614,1245940,1331,85244,1668,128359,337,2.475
WA,Clallam County,28802,1839111,1705,90228,2417,176996,712,2.472
OK,Ellis County,1295,76847,56,2502,88,4006,32,2.471
ID,Custer County,1504,73017,118,5268,155,9675,37,2.46
TX,Hays County,66538,5433993,8172,415538,9807,710893,1635,2.457
KY,Shelby County,15920,1238951,1262,70155,1653,115321,391,2.456
TX,Burnet County,16667,1336803,1490,96789,1898,162765,408,2.448
NC,Macon County,12404,711688,729,34349,1031,62540,302,2.435
AR,Benton County,87242,13820588,7237,511876,9356,571782,2119,2.429
MI,Crawford County,4763,224859,339,12439,454,21241,115,2.414
NC,Cabarrus County,69266,5251563,6378,370437,8033,450293,1655,2.389
AZ,La Paz County,4905,201858,487,19477,604,27028,117,2.385
TX,Collin County,321347,38127439,33175,2801762,40818,3422375,7643,2.378
GA,Harris County,10892,870382,929,57762,1187,108736,258,2.369
TN,Fayette County,14830,1197950,1192,77378,1543,125710,351,2.367
UT,Tooele County,20299,1379198,1946,103625,2425,127520,479,2.36
SC,Spartanburg County,104846,6599512,5592,275442,8065,402817,2473,2.359
TX,Montague County,6414,375967,486,20500,636,38370,150,2.339
SC,Berkeley County,69825,4641640,8591,463164,10206,622780,1615,2.313
TN,Williamson County,76424,12242435,7311,788870,9068,1159148,1757,2.299
NC,Yancey County,5968,291333,287,10895,424,21493,137,2.296
TX,Foard County,393,18187,21,750,30,1346,9,2.29
GA,Echols County,962,40301,55,1807,77,2659,22,2.287
NV,Lincoln County,1313,77372,78,3613,108,5967,30,2.285
GA,Rabun County,5693,326324,380,23856,510,48666,130,2.284
WA,Island County,31547,2472699,3691,221091,4411,277615,720,2.282
GA,Oconee County,12714,1537203,1117,85851,1407,129153,290,2.281
MI,Alcona County,3917,188310,272,10487,361,18352,89,2.272
TX,Johnson County,55426,3682538,4940,264766,6198,341215,1258,2.27
NC,Moore County,34245,2697934,2714,170905,3490,277716,776,2.266
MO,Warren County,12108,764850,984,45967,1258,65043,274,2.263
TN,Loudon County,19256,1461031,1556,90480,1991,164479,435,2.259
TX,Coke County,1064,59161,81,4025,105,6037,24,2.256
KS,Decatur County,1110,45410,39,1869,64,2181,25,2.252
WA,Skamania County,3841,315123,338,19096,424,31797,86,2.239
WA,Lewis County,27172,1605862,1792,74936,2399,123830,607,2.234
TX,Guadalupe County,54308,3777542,6078,348333,7282,446349,1204,2.217
WA,Grays Harbor County,23895,1353427,1514,72616,2041,115040,527,2.205
MT,Jefferson County,4268,319877,373,20265,467,34891,94,2.202
NC,Pender County,18454,1160332,1740,80447,2146,131305,406,2.2
MO,Benton County,6325,274766,497,16432,636,30900,139,2.198
GA,Walton County,29177,1925175,2615,147598,3256,177794,641,2.197
TN,Overton County,7063,324924,455,16473,609,27879,154,2.18
ID,Payette County,7587,507521,707,28344,871,41816,164,2.162
OR,Linn County,42579,2530422,3159,139757,4078,203202,919,2.158
MT,Deer Lodge County,3247,175351,234,9570,304,13054,70,2.156
TX,Grimes County,8616,484598,705,31756,890,47155,185,2.147
TN,Grainger County,7179,345239,508,18952,662,29360,154,2.145
TX,Winkler County,2285,295701,208,14632,257,11938,49,2.144
NC,Clay County,3591,185385,289,10913,366,19562,77,2.144
TN,Jackson County,3501,148919,274,8914,349,13808,75,2.142
VA,King William County,6445,423071,472,24411,609,31652,137,2.126
VA,Frederick County,32111,2427790,2551,143722,3233,206752,682,2.124
NV,Douglas County,20595,1957553,1726,126105,2163,210424,437,2.122
OH,Delaware County,71895,9210488,5954,556882,7478,659295,1524,2.12
TX,Hill County,11348,610192,950,38247,1190,58017,240,2.115
TN,Meigs County,3832,197357,379,15708,460,21162,81,2.114
OR,Coos County,21669,1256702,1416,69852,1874,89355,458,2.114
TN,Union County,5773,271476,478,17383,600,26387,122,2.113
TX,Ector County,50906,3563188,3812,239694,4886,251450,1074,2.11
GA,Hart County,8029,425370,537,23888,706,40150,169,2.105
MI,Kalkaska County,6441,314483,492,20777,627,28225,135,2.096
TN,Bledsoe County,3544,161788,242,9058,316,13119,74,2.088
FL,Levy County,12981,579315,1183,45063,1453,58281,270,2.08
NC,Currituck County,9171,607091,838,43477,1028,63975,190,2.072
TX,Fannin County,10473,605206,853,41506,1068,55672,215,2.053
CO,Fremont County,14134,760201,1098,47580,1388,67811,290,2.052
ID,Shoshone County,4164,193335,305,12430,390,16222,85,2.041
AZ,Navajo County,30364,1433215,2405,106421,3024,141791,619,2.039
FL,Lee County,267184,21814777,18787,1213264,24236,2365945,5449,2.039
NC,Alamance County,56556,3367906,3558,164456,4709,226472,1151,2.035
GA,White County,8672,478255,750,29515,926,48303,176,2.03
TX,Real County,1184,58578,89,3913,113,5603,24,2.027
OR,Tillamook County,9570,606683,701,31575,894,51203,193,2.017
NY,Hamilton County,2082,124074,122,5573,164,9967,42,2.017
AR,Marion County,5007,208624,432,16875,533,25242,101,2.017
KY,Scott County,18422,1328706,1644,86989,2013,129611,369,2.003
TN,Jefferson County,17161,925809,1567,63162,1910,91965,343,1.999
NC,Haywood County,22190,1192514,1353,61229,1795,100207,442,1.992
TN,Sumner County,64493,5106223,5401,299666,6681,396465,1280,1.985
KS,Clark County,707,39248,33,1881,47,2490,14,1.98
CA,Sierra County,960,55257,70,3791,89,5479,19,1.979
TN,Perry County,2480,126614,108,3357,157,6600,49,1.976
AR,Perry County,2997,156384,193,7327,252,10356,59,1.969
GA,Talbot County,1982,84733,140,5462,179,6297,39,1.968
IN,Hancock County,28337,2210812,2360,142147,2917,172937,557,1.966
GA,Newton County,34094,1772375,3540,147967,4209,165395,669,1.962
GA,Charlton County,2659,124673,203,6681,255,9609,52,1.956
KY,Simpson County,6356,329602,461,17344,585,20412,124,1.951
NC,Hoke County,14378,675818,2287,101557,2567,103372,280,1.947
GA,Columbia County,47302,4115242,5099,331699,6020,372163,921,1.947
KS,Cheyenne County,977,40659,25,1433,44,1774,19,1.945
WA,Lincoln County,3650,230728,255,11307,326,17339,71,1.945
TX,Hamilton County,2729,192170,227,10830,280,12606,53,1.942
TX,Denton County,274749,28174824,30734,2281370,36068,2711365,5334,1.941
TX,Midland County,55303,8083422,5550,548096,6623,580266,1073,1.94
TX,Henderson County,25311,1399681,2156,92303,2645,148778,489,1.932
VA,Nelson County,5858,396681,330,20937,443,31269,113,1.929
OR,Columbia County,18175,1243566,1276,70088,1626,87082,350,1.926
TN,Benton County,5249,243342,292,10843,393,14410,101,1.924
WI,Marquette County,6188,321174,449,16037,568,28527,119,1.923
CO,Washington County,1511,75568,75,3256,104,3863,29,1.919
MO,Christian County,28261,1918834,2819,159229,3361,194223,542,1.918
WA,Cowlitz County,37276,2397427,2567,127460,3282,176755,715,1.918
VA,Westmoreland County,6622,385728,557,30260,684,47327,127,1.918
FL,Highlands County,32767,1503479,2539,97897,3167,139563,628,1.917
NV,Clark County,796439,57282761,38284,2175811,53538,3777011,15254,1.915
ID,Jefferson County,8202,498217,795,40006,951,55123,156,1.902
MT,Sanders County,3944,178351,288,12109,363,19335,75,1.902
TX,Lynn County,1846,110279,135,5526,170,12307,35,1.896
MN,Cass County,11027,655216,889,45549,1098,73490,209,1.895
TX,Concho County,740,33282,81,3468,95,6981,14,1.892
IN,Hamilton County,115104,15313766,9773,836451,11945,1018223,2172,1.887
MT,Lincoln County,6468,312603,449,19442,571,29008,122,1.886
TX,Burleson County,6173,380228,423,18504,539,28589,116,1.879
GA,Morgan County,6401,452406,455,27849,575,37985,120,1.875
TN,Hickman County,7418,361856,591,22046,730,28407,139,1.874
NC,Ashe County,9059,459899,420,20217,589,31975,169,1.866
WA,Thurston County,105491,7898212,9194,518352,11152,619428,1958,1.856
OK,Dewey County,1563,121172,111,6624,140,6178,29,1.855
NC,Union County,73743,7189462,5304,417851,6665,657435,1361,1.846
WA,Stevens County,14607,873343,1145,54498,1414,79971,269,1.842
TX,Culberson County,761,34864,53,2141,67,3150,14,1.84
GA,Henry County,73572,4651381,8198,401287,9552,411315,1354,1.84
CO,Elbert County,8920,987976,987,71000,1151,95840,164,1.839
NC,Camden County,3484,235011,305,16831,369,17993,64,1.837
OR,Jefferson County,7305,371087,619,24601,753,36410,134,1.834
FL,Volusia County,196530,11358882,13728,623525,17323,991763,3595,1.829
TX,Grayson County,44243,2883191,3100,158430,3906,226436,806,1.822
TX,Bosque County,5926,344886,498,27785,606,29238,108,1.822
KS,Lane County,660,28969,28,1268,40,1423,12,1.818
SC,Oconee County,26050,1735489,1513,91590,1984,149189,471,1.808
VA,Middlesex County,4094,274067,256,13445,330,20703,74,1.808
MT,Flathead County,38918,2650198,2324,101775,3025,194175,701,1.801
VA,Mathews County,3354,231619,199,9873,259,17047,60,1.789
UT,Beaver County,2020,111672,125,5549,161,6736,36,1.782
TN,Van Buren County,1805,79582,127,6407,159,6741,32,1.773
CA,Placer County,141595,15230760,11421,782704,13923,1180411,2502,1.767
GA,Lumpkin County,9059,556390,944,44058,1104,60446,160,1.766
OR,Sherman County,624,39854,36,1562,47,2057,11,1.763
GA,Putnam County,7156,440276,583,29167,709,61800,126,1.761
TX,Atascosa County,15613,902099,1219,54516,1494,66618,275,1.761
WY,Sublette County,3132,301278,236,15935,291,20228,55,1.756
CA,San Benito County,21706,1732592,1529,109869,1910,142750,381,1.755
NC,Iredell County,61595,4958454,4559,310981,5640,414468,1081,1.755
CO,Kiowa County,456,22707,21,617,29,1406,8,1.754
CO,Delta County,10302,524861,751,34145,929,47151,178,1.728
CO,Montrose County,14668,847038,1070,48714,1323,74152,253,1.725
TX,Van Zandt County,17095,993741,1402,69838,1696,87164,294,1.72
MN,Lake County,4185,255511,229,10849,301,16341,72,1.72
IN,Hendricks County,59416,4914037,5204,299206,6224,337156,1020,1.717
WV,Morgan County,6357,320139,396,17320,505,23861,109,1.715
KY,Meade County,9626,575555,1069,46482,1234,56173,165,1.714
AR,Baxter County,14071,759342,926,34661,1165,55850,239,1.699
GA,Bartow County,33131,2017287,2697,126354,3255,152508,558,1.684
TN,Dickson County,18301,1088879,1291,53133,1599,84349,308,1.683
CO,Teller County,9097,642303,1141,63832,1294,98442,153,1.682
WI,Forest County,3391,195237,125,4770,182,10555,57,1.681
WI,Sawyer County,6648,377435,419,21288,530,42810,111,1.67
GA,Lincoln County,2576,135708,136,5324,179,9695,43,1.669
WA,Ferry County,2108,111251,177,9220,212,10600,35,1.66
GA,McIntosh County,3623,180546,301,12337,361,18796,60,1.656
TX,Fort Bend County,240466,25001573,19762,1480164,23731,1672986,3969,1.651
GA,Candler County,3033,135326,227,7667,277,19193,50,1.649
AR,Randolph County,5343,234703,347,14223,435,14846,88,1.647
SD,Custer County,3341,218122,325,14385,380,24636,55,1.646
ID,Clearwater County,2738,146211,183,8157,228,9711,45,1.644
GA,Atkinson County,2255,85461,139,5503,176,5186,37,1.641
TN,Blount County,47263,3090535,3030,156466,3802,240454,772,1.633
NC,Henderson County,42251,2644293,3156,169335,3845,239749,689,1.631
SC,Georgetown County,22894,1604626,1640,91661,2012,167409,372,1.625
FL,Bradford County,7768,412975,616,24468,742,28602,126,1.622
MT,Granite County,1111,63593,96,4855,114,8544,18,1.62
SC,Kershaw County,22110,1278025,1393,62437,1751,84967,358,1.619
WA,Franklin County,28292,1723313,2637,132505,3094,150281,457,1.615
TN,Moore County,2171,140443,189,7330,224,9280,35,1.612
VA,Buckingham County,5094,245144,290,10677,372,16373,82,1.61
NC,McDowell County,14789,718159,684,29420,922,47640,238,1.609
FL,Suwannee County,12641,580805,1041,34681,1244,46573,203,1.606
NM,Sandoval County,50083,3280355,4263,242060,5067,308967,804,1.605
TN,Fentress County,5482,242125,307,11364,395,20115,88,1.605
TN,Coffee County,18882,1062962,1505,69866,1807,77930,302,1.599
WI,Vilas County,9209,549646,641,39339,788,58729,147,1.596
ID,Lincoln County,1505,70628,112,3891,136,5779,24,1.595
TN,Cheatham County,14691,925454,1322,69308,1556,82557,234,1.593
KY,Allen County,6156,295353,377,13368,475,18808,98,1.592
WA,Clark County,175569,15439902,11605,755339,14398,966959,2793,1.591
VA,Powhatan County,10628,1002140,738,51039,907,71800,169,1.59
CO,Broomfield County,23522,2694139,4751,359012,5125,381334,374,1.59
OK,Wagoner County,24142,1642001,2613,130282,2996,165050,383,1.586
TN,Hancock County,1833,68019,79,2117,108,4251,29,1.582
CO,Las Animas County,4627,226234,351,14630,424,17664,73,1.578
FL,Baker County,8193,458930,509,20413,638,29572,129,1.575
MS,DeSoto County,61296,3917758,4877,234309,5835,272763,958,1.563
TN,Macon County,7484,344199,485,15378,602,21457,117,1.563
MI,Benzie County,7048,410484,557,28638,667,44076,110,1.561
SD,Butte County,3657,192376,316,13430,373,13669,57,1.559
WA,Pend Oreille County,4173,370781,398,21703,463,28861,65,1.558
AZ,Gila County,16962,872935,1215,58993,1477,87616,262,1.545
WY,Lincoln County,6474,516503,454,28933,554,39794,100,1.545
CA,Amador County,13491,940576,911,49443,1119,71015,208,1.542
WI,Burnett County,6300,331278,398,17749,495,31912,97,1.54
IN,Benton County,3188,161979,225,8079,274,10285,49,1.537
TN,Cocke County,11853,477728,675,21261,857,29190,182,1.535
VA,Fluvanna County,9583,674777,776,46051,923,57748,147,1.534
MI,Roscommon County,8874,426160,747,30284,883,45250,136,1.533
CO,Denver County,254974,25477696,40481,2667509,44384,3124332,3903,1.531
TN,Morgan County,5883,288302,341,12289,431,15569,90,1.53
NV,Washoe County,178496,16003020,10402,693684,13133,1186613,2731,1.53
WA,Skagit County,46815,3477003,3236,195397,3950,308919,714,1.525
TN,Rutherford County,109020,7204142,9790,500433,11453,535217,1663,1.525
TX,Mason County,1508,86725,90,4372,113,7504,23,1.525
AL,Cherokee County,7440,370732,441,17422,554,28923,113,1.519
AR,Stone County,3622,149451,200,7043,255,9075,55,1.518
FL,Columbia County,21202,1066727,1623,63483,1944,79545,321,1.514
TX,Lampasas County,6959,428772,683,30342,788,43115,105,1.509
AR,Izard County,3672,168306,282,9896,337,13064,55,1.498
WA,Spokane County,186604,13175234,9669,494530,12461,719550,2792,1.496
WA,Douglas County,14266,904307,1420,70427,1632,88742,212,1.486
SC,Beaufort County,64829,6133414,6046,385995,7009,776198,963,1.485
TX,Gillespie County,10389,963216,711,49583,865,77091,154,1.482
VA,Dinwiddie County,10062,578848,790,32416,939,37948,149,1.481
TN,Franklin County,14331,827362,906,43620,1118,60429,212,1.479
NC,Stanly County,20761,1191101,1030,43712,1336,61654,306,1.474
GA,Spalding County,20351,1036154,1858,76838,2158,89097,300,1.474
VA,Bedford County,28425,2127642,2045,120210,2462,152618,417,1.467
MO,Camden County,15484,952210,1480,67773,1707,105834,227,1.466
ME,Lincoln County,14320,884327,928,47128,1138,74466,210,1.466
GA,Franklin County,6839,353017,604,21302,704,28913,100,1.462
MO,Iron County,2944,133982,212,6787,255,7166,43,1.461
TX,Wilson County,16083,1224241,1278,72578,1513,112598,235,1.461
MN,Chisago County,20863,1643790,1630,92023,1933,111675,303,1.452
GA,Habersham County,13794,773587,929,45860,1129,54555,200,1.45
VA,Orange County,13179,919390,1295,71204,1486,95110,191,1.449
TX,Medina County,15499,1008858,1211,58822,1435,78910,224,1.445
MN,Hubbard County,7551,461467,562,31191,671,35900,109,1.444
MD,Frederick County,96951,8925877,6822,474656,8215,565097,1393,1.437
TN,White County,8649,395268,621,20865,745,32290,124,1.434
FL,Glades County,3001,171193,373,14790,416,17369,43,1.433
NC,Gaston County,74925,4594517,5235,248777,6309,306681,1074,1.433
FL,Clay County,73883,4941020,7908,448768,8965,529836,1057,1.431
GA,Webster County,701,27139,40,1137,50,1526,10,1.427
FL,Okaloosa County,75605,5353520,8641,474484,9720,611755,1079,1.427
SC,Lexington County,99464,7056130,7544,399906,8957,466842,1413,1.421
WI,Iron County,2538,132850,133,4832,169,9632,36,1.418
TX,Leon County,5717,303052,423,19081,504,29540,81,1.417
GA,Jasper County,4307,269426,358,12765,419,24097,61,1.416
TX,Archer County,2902,205739,191,8390,232,13267,41,1.413
WA,Asotin County,7722,512303,690,29686,799,35180,109,1.412
OK,Okfuskee County,3048,132238,177,6217,220,8022,43,1.411
NH,Carroll County,20715,1732343,1397,84791,1689,172857,292,1.41
MN,Kanabec County,5753,314663,381,15633,462,20692,81,1.408
ME,Piscataquis County,5832,274080,343,14073,425,17748,82,1.406
FL,Brevard County,223514,14831323,13796,856882,16934,1147566,3138,1.404
ID,Camas County,356,20479,26,1549,31,1773,5,1.404
SC,Greenville County,174000,13638831,12030,722725,14471,898887,2441,1.403
OR,Wasco County,8916,512071,700,33008,825,39401,125,1.402
GA,Coweta County,47355,3716489,3931,243638,4594,302171,663,1.4
ND,Dunn County,1502,135011,169,10549,190,10789,21,1.398
NE,Washington County,7585,662291,558,32122,664,44953,106,1.397
CA,Calaveras County,15854,1096750,1273,75460,1494,116076,221,1.394
TX,Comanche County,4306,196510,293,9911,353,19710,60,1.393
UT,Sanpete County,7177,389378,568,23772,668,31066,100,1.393
AZ,Maricopa County,1471961,117024435,67741,4328950,88231,6573244,20490,1.392
NC,Transylvania County,11518,707799,820,44435,980,77582,160,1.389
IN,Washington County,9796,476591,533,20429,669,28571,136,1.388
CA,Tehama County,19635,1090007,1386,66719,1658,80518,272,1.385
TN,Clay County,2389,96929,140,3436,173,6443,33,1.381
UT,Juab County,3260,202144,256,11298,301,15514,45,1.38
VA,Loudoun County,138834,19882301,12880,1359749,14791,1522040,1911,1.376
OH,Union County,20287,1842950,1695,126710,1974,156706,279,1.375
OR,Josephine County,29142,1699366,1996,82376,2396,114170,400,1.373
GA,Berrien County,5026,243315,407,14091,476,13413,69,1.373
MT,Mineral County,1460,80378,139,6104,159,7507,20,1.37
TN,Putnam County,24611,1502546,2026,83331,2363,132623,337,1.369
WA,Kitsap County,98909,8459775,8624,516563,9973,705182,1349,1.364
TX,Palo Pinto County,9019,521199,742,36848,865,54796,123,1.364
TX,Tyler County,5657,288007,387,16942,464,22434,77,1.361
GA,Miller County,1625,76000,131,4092,153,5649,22,1.354
WI,Door County,12869,893952,691,41937,865,69360,174,1.352
TN,Smith County,6588,429994,462,19315,551,25101,89,1.351
TX,Franklin County,3256,177753,306,10037,350,16510,44,1.351
MN,Pope County,4462,292235,278,17133,338,20198,60,1.345
TN,Roane County,18173,1125599,1281,58052,1525,82039,244,1.343
MS,Hancock County,13738,776936,1164,50648,1348,67144,184,1.339
NC,Alexander County,12181,655225,681,29725,844,39091,163,1.338
MT,Park County,6890,396772,594,29047,686,45683,92,1.335
NH,Coos County,11832,618605,686,29568,844,45447,158,1.335
ND,Steele County,750,55745,22,1126,32,1373,10,1.333
CA,El Dorado County,70039,7227334,5497,420607,6429,617910,932,1.331
WY,Crook County,2632,211522,180,9063,215,11179,35,1.33
TN,Cannon County,4740,239504,383,15686,446,21629,63,1.329
TX,Cooke County,13813,968128,1046,52487,1229,83645,183,1.325
CA,Plumas County,6962,430849,509,24216,601,37497,92,1.321
KS,Morris County,2047,110628,102,4362,129,6140,27,1.319
FL,Osceola County,120238,5598735,15247,598315,16832,837528,1585,1.318
NE,Perkins County,1062,55647,28,1321,42,1892,14,1.318
AR,Saline County,39392,2694599,2999,155016,3517,180093,518,1.315
MT,Stillwater County,3424,241545,243,14598,288,19748,45,1.314
NE,Hayes County,305,4234,22,574,26,997,4,1.311
NC,Carteret County,24716,1612572,1900,92755,2224,159574,324,1.311
MO,Stone County,10681,585218,1132,47455,1272,83370,140,1.311
MI,Alger County,3280,188939,149,6626,192,9383,43,1.311
ID,Blaine County,9545,1094504,618,37403,743,107966,125,1.31
KY,Trimble County,2827,154761,223,8149,260,10044,37,1.309
MD,Worcester County,21316,1571637,1649,88364,1927,134082,278,1.304
AL,Russell County,16861,742780,2386,90500,2605,98118,219,1.299
TX,Caldwell County,13478,695896,1345,55528,1520,64514,175,1.298
GA,Banks County,5266,285933,573,21995,641,27427,68,1.291
ME,Sagadahoc County,14591,1018294,1217,68029,1405,76811,188,1.288
OK,Logan County,14283,1099210,1335,82862,1519,99426,184,1.288
TN,Sequatchie County,4747,262929,366,14017,427,22799,61,1.285
GA,Lamar County,5405,272403,460,16989,529,24118,69,1.277
GA,Haralson County,8586,486340,724,28695,833,36076,109,1.27
TN,Hardin County,8356,401113,487,17097,593,35102,106,1.269
GA,Madison County,9229,482467,681,24931,798,31315,117,1.268
TN,McMinn County,17226,927755,1131,41368,1349,54859,218,1.266
ME,York County,84439,5840835,5206,290171,6274,400274,1068,1.265
OR,Douglas County,36511,1975864,2117,98973,2578,114980,461,1.263
SD,Union County,6017,929120,561,39879,637,55128,76,1.263
FL,Collier County,141277,20859061,10536,966864,12321,2727095,1785,1.263
CO,Grand County,5703,447418,727,46815,799,55384,72,1.262
VA,Spotsylvania County,46529,3799358,4535,271563,5121,297961,586,1.259
MO,Knox County,1351,53964,57,1757,74,2819,17,1.258
WA,Garfield County,718,39004,53,2640,62,2802,9,1.253
UT,Grand County,3680,239391,363,16522,409,16614,46,1.25
OH,Warren County,83398,8418367,6958,556336,7996,600989,1038,1.245
AZ,Graham County,8832,475349,558,30940,668,27533,110,1.245
OR,Klamath County,21866,1168096,1581,73347,1853,84387,272,1.244
VA,Culpeper County,17533,1284125,1397,82347,1615,95056,218,1.243
CA,Yuba County,21816,1191151,2698,118629,2969,133196,271,1.242
NV,Churchill County,8550,489626,919,43486,1025,49417,106,1.24
MN,Aitkin County,5839,324252,409,18408,481,29928,72,1.233
GA,Crawford County,3737,178518,292,9967,338,12419,46,1.231
TN,Greene County,23617,1156509,1105,43295,1395,61845,290,1.228
MO,Morgan County,6527,321396,563,20826,643,28338,80,1.226
NC,Davidson County,57675,3395591,3582,158850,4289,209422,707,1.226
MO,Miller County,7997,369653,626,20314,724,28863,98,1.225
NM,Sierra County,3758,130593,272,9866,318,11069,46,1.224
NE,Kimball County,1226,60620,84,3839,99,3793,15,1.223
MI,Missaukee County,5159,242032,371,13410,434,18277,63,1.221
MT,Judith Basin County,740,35437,32,1219,41,1609,9,1.216
IA,Warren County,18188,1554803,1413,75097,1634,89905,221,1.215
MN,Lake of the Woods County,1567,89557,83,3470,102,5358,19,1.213
MO,Cass County,37615,2738149,2886,143237,3342,195435,456,1.212
GA,Stephens County,8006,416182,564,21734,661,33333,97,1.212
WA,Whatcom County,81068,6094016,4917,265593,5892,368780,975,1.203
TN,Stewart County,4321,221749,348,14013,400,18445,52,1.203
IA,Howard County,3661,195280,165,8250,209,9224,44,1.202
CO,Mesa County,54278,3604644,3527,175854,4179,228083,652,1.201
OH,Fairfield County,55048,3990611,4199,223528,4859,251024,660,1.199
CO,Montezuma County,9200,505907,693,30815,803,41881,110,1.196
TX,Fayette County,9039,677043,525,23714,633,50912,108,1.195
MO,Henry County,7370,387008,560,20633,648,28751,88,1.194
ID,Benewah County,3109,148009,214,7501,251,13632,37,1.19
UT,Garfield County,1597,78466,110,5117,129,6780,19,1.19
TN,Houston County,2604,131281,163,5592,194,6964,31,1.19
KY,Gallatin County,2696,138815,245,9226,277,11597,32,1.187
FL,Hamilton County,3627,160764,256,7703,299,11016,43,1.186
AR,Sharp County,4809,200533,473,15579,530,18910,57,1.185
NE,Clay County,2281,153177,117,5128,144,5063,27,1.184
GA,Pierce County,5750,322783,416,15488,484,20169,68,1.183
OH,Madison County,14803,984351,1180,60181,1355,68156,175,1.182
NC,Granville County,19819,1191723,1468,71419,1702,88557,234,1.181
TX,Bell County,108393,6146329,14482,673718,15759,657336,1277,1.178
WI,Oconto County,14982,920948,887,46285,1063,59415,176,1.175
MT,Big Horn County,3404,150317,185,7787,225,8069,40,1.175
TN,Marion County,9550,538473,548,28326,660,35351,112,1.173
UT,Box Elder County,17261,1096032,1243,62062,1445,72842,202,1.17
VA,Craig County,1796,92895,88,4625,109,4486,21,1.169
WA,Pierce County,316437,24389982,27483,1541543,31180,1825198,3697,1.168
TX,Kimble County,1543,80513,105,7343,123,7106,18,1.167
NC,Mitchell County,4889,234091,250,9825,307,11877,57,1.166
OK,McIntosh County,5503,255883,502,20145,566,25726,64,1.163
MN,Carver County,37236,4758987,3011,290412,3444,284037,433,1.163
GA,Hall County,65464,4566753,4964,276527,5724,374269,760,1.161
VA,Bland County,2069,109561,93,4138,117,4663,24,1.16
MD,Kent County,7332,581669,495,29673,580,38759,85,1.159
KS,Rush County,1210,56117,55,1698,69,2180,14,1.157
MN,Isanti County,14883,981089,1336,65818,1508,78409,172,1.156
IA,Monroe County,2692,147405,140,5087,171,7694,31,1.152
TX,Falls County,4901,220878,359,17286,415,17876,56,1.143
MI,Lake County,3503,153954,375,13281,415,17178,40,1.142
TN,Lawrence County,13660,685901,691,24520,847,35732,156,1.142
TX,Menard County,702,29126,36,1153,44,2853,8,1.14
OR,Clatsop County,14053,875525,1310,68182,1470,77114,160,1.139
TX,Kerr County,19135,1509411,1436,75571,1654,110400,218,1.139
NM,Los Alamos County,7288,905640,658,64884,741,56301,83,1.139
OH,Morrow County,12208,690689,901,42662,1040,48777,139,1.139
VA,Botetourt County,12615,961657,849,45454,992,58699,143,1.134
KY,Breckinridge County,6353,323141,390,13081,462,18126,72,1.133
CA,Nevada County,38701,3055710,2998,204597,3436,270648,438,1.132
NC,Rutherford County,20741,1031444,1034,43251,1268,65185,234,1.128
IN,Brown County,5939,376777,493,24019,560,31228,67,1.128
GA,Polk County,12518,604544,856,32811,997,39068,141,1.126
KY,Bullitt County,29076,1833884,2300,108118,2627,125107,327,1.125
VA,Rockingham County,30142,2001091,1773,90463,2111,118957,338,1.121
NC,Dare County,15009,1028374,1144,54142,1312,96948,168,1.119
NM,Catron County,1073,42582,60,4109,72,3321,12,1.118
FL,Pinellas County,369741,27015006,26591,1501981,30718,2323323,4127,1.116
OR,Grant County,2421,118750,148,5752,175,9263,27,1.115
NM,Torrance County,4308,175313,338,12027,386,15951,48,1.114
ID,Boundary County,4040,204896,312,13329,357,21278,45,1.114
NE,Burt County,2516,142394,126,4677,154,5687,28,1.113
KY,Metcalfe County,3148,120342,193,6191,228,8436,35,1.112
MO,Platte County,35890,3619257,4675,284024,5074,311472,399,1.112
MD,Talbot County,14938,1444285,1017,81151,1183,118497,166,1.111
MI,Manistee County,9278,482198,559,21669,662,32144,103,1.11
TN,Robertson County,25634,1549539,2120,104973,2404,129372,284,1.108
CO,Clear Creek County,3445,320918,467,35249,505,36510,38,1.103
MI,Mackinac County,4651,228917,350,18802,401,20351,51,1.097
NE,Gosper County,729,46552,55,2764,63,2783,8,1.097
AL,St. Clair County,28340,1776062,2139,108142,2449,130090,310,1.094
VA,James City County,28366,3120311,2900,195067,3210,257735,310,1.093
NC,Wake County,379272,37937491,29853,2009623,33999,2380346,4146,1.093
GA,Houston County,52456,3267810,4353,213181,4926,222528,573,1.092
GA,Oglethorpe County,4580,240712,388,15126,438,17415,50,1.092
MS,Jefferson Davis County,3759,145393,204,7074,245,9562,41,1.091
MO,Clay County,89849,6666330,8048,448438,9026,476812,978,1.088
AL,Madison County,131042,10765002,8260,495996,9684,583495,1424,1.087
CO,Pueblo County,55820,3204156,3146,143428,3752,160602,606,1.086
TX,Navarro County,15592,817707,1115,52404,1284,65036,169,1.084
TX,Callahan County,4437,236205,414,16586,462,23246,48,1.082
KS,Clay County,3053,158980,181,8043,214,9700,33,1.081
DE,Kent County,62826,3691655,4185,200693,4862,235413,677,1.078
MN,Wright County,49062,4134864,3659,220933,4186,266613,527,1.074
SC,Anderson County,66543,4006676,3841,198781,4555,242950,714,1.073
ND,Kidder County,934,48463,37,1891,47,2674,10,1.071
VA,Augusta County,27907,1740704,1870,83154,2169,102353,299,1.071
MO,Gasconade County,5605,279478,341,11624,401,17350,60,1.07
TN,DeKalb County,6214,306480,479,16659,545,24146,66,1.062
MI,Antrim County,9040,572899,741,33690,837,54741,96,1.062
KY,Pulaski County,20458,1060743,958,41746,1175,56087,217,1.061
WI,Polk County,17527,1070299,1076,52635,1262,70454,186,1.061
WI,Oneida County,15987,1040897,1006,50771,1175,73108,169,1.057
FL,Putnam County,22069,985265,1720,65000,1953,82930,233,1.056
TX,Clay County,3506,208308,275,13159,312,15006,37,1.055
TX,Ward County,3603,268131,331,19883,369,18983,38,1.055
MI,Ogemaw County,7402,330620,504,18657,582,23332,78,1.054
MD,Queen Anne's County,18875,1864551,1361,93186,1560,123329,199,1.054
ME,Hancock County,22033,1380564,1201,72453,1433,89567,232,1.053
OR,Wallowa County,2755,149202,161,6987,190,10700,29,1.053
VA,Cumberland County,3338,159728,270,10796,305,12430,35,1.049
GA,Walker County,19559,1007688,1626,66033,1831,73571,205,1.048
IA,Mitchell County,3912,237062,183,10637,224,9690,41,1.048
VA,Stafford County,48130,4615515,6125,415650,6629,423111,504,1.047
WA,Grant County,31550,1835683,1797,80163,2127,100812,330,1.046
GA,Cook County,4784,212109,375,10887,425,12394,50,1.045
MI,Clare County,10151,475466,826,31645,932,43791,106,1.044
KY,Owen County,3360,179971,238,9358,273,10798,35,1.042
MI,Iosco County,9554,440315,685,26280,784,38214,99,1.036
TX,Colorado County,7345,457637,471,21562,547,33430,76,1.035
OH,Ottawa County,17205,1131988,1049,55629,1227,95444,178,1.035
MO,Cedar County,4347,175161,334,12052,379,14517,45,1.035
TX,Eastland County,5624,193997,413,19282,471,19092,58,1.031
FL,Martin County,58840,7068560,5355,393034,5960,1072959,605,1.028
OR,Jackson County,79950,5197804,4658,239836,5479,313645,821,1.027
ME,Washington County,11220,507701,510,20773,625,34978,115,1.025
TX,Coleman County,2742,144390,175,6368,203,10397,28,1.021
UT,Weber County,83802,5578998,6395,323259,7249,366800,854,1.019
ID,Bonneville County,37389,2960254,2882,146563,3263,172875,381,1.019
AZ,Pima County,357693,23566216,18183,1047202,21813,1426356,3630,1.015
IN,Floyd County,29159,2406583,2535,137124,2831,146894,296,1.015
NM,Eddy County,18166,1523348,1254,80993,1438,84245,184,1.013
CA,Lake County,19567,1014962,1347,65090,1545,79905,198,1.012
FL,DeSoto County,9383,412472,791,30455,886,40435,95,1.012
SD,Tripp County,2081,102327,68,3318,89,2990,21,1.009
WI,Florence County,1788,99321,122,5291,140,7239,18,1.007
CA,Glenn County,9636,530857,559,22442,656,27817,97,1.007
NC,Buncombe County,98143,7003228,7851,408555,8837,566263,986,1.005
NC,Person County,13654,734902,615,26023,752,36097,137,1.003
MT,Lewis and Clark County,26887,1879736,1802,97551,2071,112320,269,1.0
TX,Houston County,6403,302787,410,15747,474,24570,64,1.0
NE,Sarpy County,64713,5416264,6982,415062,7627,426080,645,0.997
VA,Caroline County,10832,652553,1099,53504,1207,60741,108,0.997
AL,Elmore County,27303,1767149,2187,100134,2459,120603,272,0.996
OR,Yamhill County,35261,2601899,2750,154141,3101,197749,351,0.995
SC,Edgefield County,7974,481707,633,30726,712,41632,79,0.991
WI,St. Croix County,34450,3259382,2398,176143,2739,187565,341,0.99
OK,Bryan County,13366,710804,1016,36860,1148,49517,132,0.988
MO,Barry County,10943,543469,951,39472,1059,42070,108,0.987
MN,Sherburne County,33542,2709018,3331,193432,3661,198032,330,0.984
MO,Dade County,2447,107483,160,4941,184,7880,24,0.981
SD,Jerauld County,715,34858,24,899,31,1392,7,0.979
TN,Campbell County,11760,554276,625,21451,740,32979,115,0.978
KS,Kiowa County,820,49802,44,1694,52,2905,8,0.976
OH,Pickaway County,19497,1207226,1521,66554,1711,84881,190,0.975
TN,Humphreys County,6262,350498,385,17371,446,24165,61,0.974
VA,Rockbridge County,8019,499380,578,29220,656,35611,78,0.973
MT,Wheatland County,617,30591,28,927,34,872,6,0.972
NC,Lee County,20169,1149838,1747,77209,1943,105291,196,0.972
TX,Upshur County,12160,696967,1203,50448,1321,64658,118,0.97
GA,Warren County,1757,68929,114,4387,131,4725,17,0.968
NM,Taos County,12085,572438,702,35833,819,49448,117,0.968
IN,Ripley County,10540,650165,705,34189,807,34871,102,0.968
VA,Clarke County,5489,545020,518,34634,571,43132,53,0.966
UT,San Juan County,3417,167736,325,13925,358,14431,33,0.966
TN,Sullivan County,55730,3363738,3328,156869,3866,183613,538,0.965
GA,Chattooga County,7167,323733,323,11470,392,15616,69,0.963
AL,Colbert County,18544,1220340,1132,48151,1310,58281,178,0.96
CO,Morgan County,9907,563325,686,31318,781,37270,95,0.959
TX,Floyd County,1879,94103,115,4912,133,5699,18,0.958
GA,Turner County,2613,109619,157,4667,182,5715,25,0.957
NM,Valencia County,23866,1194664,1478,64182,1706,71704,228,0.955
SC,Aiken County,57444,3725747,3550,190787,4098,246733,548,0.954
ME,Oxford County,20688,1037441,1302,53318,1499,71651,197,0.952
OK,McClain County,12847,964794,1284,75029,1406,77973,122,0.95
OR,Lake County,2429,125297,183,8812,206,7900,23,0.947
GA,Quitman County,635,24467,51,1711,57,2436,6,0.945
TX,Upton County,1061,89331,84,5085,94,4374,10,0.943
IN,Harrison County,14526,881057,928,44678,1065,50439,137,0.943
AL,Randolph County,7005,338958,412,22063,478,25455,66,0.942
IN,Boone County,23604,3072365,2267,214687,2489,251281,222,0.941
AR,Montgomery County,2458,106907,159,5721,182,10323,23,0.936
TN,Monroe County,14645,754925,1070,50154,1207,65187,137,0.935
KY,Clark County,12415,737988,970,46580,1086,43758,116,0.934
AR,Cleburne County,8137,429677,590,24650,666,34618,76,0.934
MD,Charles County,60779,5020214,5164,324951,5731,325012,567,0.933
MN,Otter Tail County,22943,1440400,1252,64218,1466,88846,214,0.933
TN,Bedford County,16189,930060,1143,41716,1294,53168,151,0.933
NM,Santa Fe County,60324,4759754,3946,285441,4508,369257,562,0.932
MO,Wright County,5377,210712,420,13723,470,17239,50,0.93
AR,Garland County,33487,1977673,2219,110569,2530,126788,311,0.929
TX,Cass County,9708,504054,603,28691,693,27761,90,0.927
SD,Mellette County,541,18991,25,589,30,1203,5,0.924
GA,Wayne County,8129,417339,468,16659,543,18140,75,0.923
KS,Jefferson County,6752,430067,536,26805,598,31464,62,0.918
TN,Bradley County,35290,1973216,2358,100377,2681,124965,323,0.915
TX,Somervell County,2846,211425,265,11385,291,19410,26,0.914
TX,Camp County,3954,199415,330,12570,366,19085,36,0.91
OR,Marion County,115501,7687968,7622,385658,8671,436106,1049,0.908
CO,Garfield County,20507,1744781,1783,103382,1969,114708,186,0.907
MI,Otsego County,9521,533695,697,28976,783,36358,86,0.903
TX,Trinity County,4333,198603,435,18129,474,22713,39,0.9
IA,Guthrie County,4032,280275,294,13259,330,18268,36,0.893
KY,Jessamine County,16789,1272189,1593,80921,1743,104741,150,0.893
MI,Oscoda County,2807,123042,208,6632,233,11444,25,0.891
CO,Jefferson County,222725,21708928,25086,1630334,27058,1775195,1972,0.885
CO,San Miguel County,3165,330137,381,31854,409,71277,28,0.885
WI,Bayfield County,6235,392425,392,21626,447,34571,55,0.882
WI,Waushara County,9092,486206,622,24285,702,34687,80,0.88
CO,Adams County,169932,11285903,20468,1086773,21963,1163226,1495,0.88
OK,Beaver County,1709,87103,114,4826,129,5373,15,0.878
CA,Riverside County,770647,49841912,48974,2874504,55724,3363745,6750,0.876
KY,Barren County,14511,746009,873,34098,1000,36326,127,0.875
NC,Durham County,107662,8191636,12524,773489,13466,839397,942,0.875
MN,Dakota County,166882,15635839,13379,886134,14827,862709,1448,0.868
MN,Carlton County,12802,815258,733,36958,844,44944,111,0.867
TX,Sherman County,807,48828,50,2337,57,3052,7,0.867
SC,Dorchester County,51241,3294567,6621,327729,7065,361485,444,0.866
OH,Miami County,41095,2793241,2408,117118,2763,142429,355,0.864
VA,Surry County,2431,135673,163,8217,184,8871,21,0.864
MI,Montmorency County,3479,146749,259,9038,289,12937,30,0.862
NC,Polk County,7081,465875,580,30245,641,45554,61,0.861
MN,Kittson County,1748,107957,57,2432,72,3034,15,0.858
NV,Pershing County,1523,89418,132,7111,145,5868,13,0.854
KY,Edmonson County,3747,180155,277,9452,309,11921,32,0.854
IN,Johnson County,55788,4355702,5396,306778,5869,299139,473,0.848
VA,Fauquier County,25932,2778605,2269,190114,2489,204330,220,0.848
NC,Madison County,6968,347819,539,21670,598,28089,59,0.847
TX,Cottle County,476,21103,25,678,29,1064,4,0.84
IN,Carroll County,7507,443452,561,23900,624,28325,63,0.839
NM,Otero County,20042,936550,2222,98530,2390,104026,168,0.838
CO,El Paso County,244110,18326043,25403,1376039,27445,1517081,2042,0.837
FL,Jefferson County,4544,250563,352,14751,390,22139,38,0.836
MO,Bates County,5507,284690,361,14208,407,16879,46,0.835
OK,Noble County,3599,216241,299,12758,329,14404,30,0.834
IA,Dickinson County,7095,588907,491,33896,550,37610,59,0.832
FL,Hillsborough County,497009,36158653,39799,2314898,43929,2724138,4130,0.831
GA,Wilkinson County,3010,135529,179,5730,204,7365,25,0.831
OK,Delaware County,11878,598520,1143,48080,1241,62690,98,0.825
MN,Cook County,2425,143265,141,6731,161,14284,20,0.825
WI,Langlade County,7784,410311,404,18496,468,26004,64,0.822
OK,Rogers County,30185,2339311,2657,138145,2905,177085,248,0.822
FL,Okeechobee County,11734,570870,896,35677,992,42857,96,0.818
MO,Douglas County,3926,145838,309,10683,341,12250,32,0.815
IN,Crawford County,3567,167219,280,10429,309,12948,29,0.813
PA,Carbon County,24844,1437098,1535,67008,1737,79594,202,0.813
GA,Gordon County,17401,1024588,1073,41253,1214,45496,141,0.81
AR,Jackson County,4328,205318,291,10427,326,10000,35,0.809
KY,Spencer County,6435,470434,584,35499,636,40278,52,0.808
CA,Inyo County,6580,459082,483,28213,536,26817,53,0.805
VA,Chesterfield County,126776,10815605,10288,638786,11302,685686,1014,0.8
MO,Ralls County,3634,220110,255,11059,284,13054,29,0.798
GA,Meriwether County,6643,309479,539,20856,592,24956,53,0.798
MN,Washington County,98540,11025279,8336,641259,9116,652298,780,0.792
AR,Searcy County,2282,78218,133,3396,151,6334,18,0.789
VA,Greene County,7118,470463,581,29249,637,36966,56,0.787
SD,Jones County,381,18013,20,682,23,773,3,0.787
CO,Larimer County,127102,11184048,12284,682153,13283,846664,999,0.786
AZ,Cochise County,40799,2209184,3694,194275,4014,195135,320,0.784
FL,Union County,3444,170823,331,12136,358,12655,27,0.784
MS,Lamar County,17752,1303142,2117,104460,2256,98316,139,0.783
AL,Morgan County,40420,2508187,2215,96718,2531,111968,316,0.782
ID,Franklin County,4231,230370,267,11303,300,15226,33,0.78
AR,Little River County,3847,189179,240,9330,270,10176,30,0.78
WA,Benton County,68388,5414669,5338,331343,5870,324704,532,0.778
OH,Licking County,65203,4386710,4128,219317,4634,253824,506,0.776
NC,Greene County,5799,271333,400,13537,445,13864,45,0.776
CO,Alamosa County,5030,269409,484,20684,523,21542,39,0.775
TX,McCulloch County,2719,140137,188,8121,209,9485,21,0.772
TX,Live Oak County,3532,235586,265,14984,292,13533,27,0.764
TX,Brazoria County,114621,9458165,10000,644383,10875,671446,875,0.763
TN,Claiborne County,9694,458725,569,23805,643,22687,74,0.763
NC,Beaufort County,16018,886734,935,40788,1057,61236,122,0.762
MS,George County,6846,396714,400,17954,452,19713,52,0.76
VA,Albemarle County,37574,4865173,4223,322856,4508,417727,285,0.759
MO,St. Francois County,20211,1064217,1274,46079,1427,54702,153,0.757
NE,Fillmore County,2256,147708,88,3742,105,4458,17,0.754
IA,Fremont County,2528,155351,157,6639,176,7470,19,0.752
MI,Iron County,4527,216827,198,8795,232,10673,34,0.751
SD,Minnehaha County,75524,5945477,6049,325117,6616,379767,567,0.751
WY,Park County,11611,942744,917,49507,1004,65083,87,0.749
IA,Iowa County,6407,425625,364,17052,412,19900,48,0.749
PA,Perry County,18446,1087584,947,46436,1085,50818,138,0.748
GA,Pike County,5746,391483,503,23863,546,28299,43,0.748
TX,San Jacinto County,7762,437879,841,38880,899,48439,58,0.747
ID,Bear Lake County,2011,107171,119,6313,134,6926,15,0.746
MN,Le Sueur County,10992,777339,874,50980,956,56390,82,0.746
GA,Catoosa County,20256,1200312,1932,82944,2083,89570,151,0.745
NC,Caswell County,7252,354399,465,17775,519,19333,54,0.745
CA,Tuolumne County,19362,1285160,1228,66550,1372,89474,144,0.744
WA,Kittitas County,14140,1003595,1532,69628,1637,112139,105,0.743
OR,Lane County,133608,9198152,8128,385498,9119,462384,991,0.742
KY,Hancock County,2972,173163,166,8363,188,7828,22,0.74
AR,Independence County,11436,633574,691,29260,775,31795,84,0.735
AR,Conway County,6395,362676,421,17130,468,19374,47,0.735
TX,Galveston County,111504,9271001,9342,601414,10160,722019,818,0.734
OK,Murray County,4360,248522,302,18109,334,13484,32,0.734
OR,Clackamas County,151190,15315364,13830,975799,14936,1068186,1106,0.732
TN,Trousdale County,2869,146630,284,10821,305,13203,21,0.732
OH,Lorain County,119541,7990728,5757,339957,6630,390803,873,0.73
VA,King George County,8788,757380,1029,57209,1093,62557,64,0.728
IL,Putnam County,2346,161095,145,6391,162,7221,17,0.725
NE,Cass County,9825,758723,809,43066,880,52514,71,0.723
MS,Jackson County,46533,2811640,3435,154034,3771,174613,336,0.722
NM,Colfax County,4167,215435,315,12749,345,19155,30,0.72
MI,Cheboygan County,10017,564414,693,32862,765,50543,72,0.719
ME,Somerset County,17527,872431,1174,54012,1300,54618,126,0.719
NH,Merrimack County,59085,4896308,4614,382389,5038,310543,424,0.718
MI,Wexford County,11997,599648,936,37613,1022,41370,86,0.717
MI,Keweenaw County,838,46830,48,1810,54,2934,6,0.716
TX,Coryell County,19029,952038,3700,141470,3836,147831,136,0.715
VA,Appomattox County,5591,307724,345,14219,385,16535,40,0.715
AR,Van Buren County,4905,232047,361,14315,396,19359,35,0.714
PA,Pike County,20866,1412351,1693,105559,1842,135397,149,0.714
ID,Twin Falls County,28464,1526081,2093,92958,2296,111399,203,0.713
TX,Lamar County,16471,888008,926,37281,1043,47176,117,0.71
IL,Macoupin County,16863,993915,936,36329,1055,50634,119,0.706
CA,Siskiyou County,15015,790779,963,34321,1069,54925,106,0.706
VA,Isle of Wight County,13612,1065565,1247,72982,1343,94258,96,0.705
MO,Dallas County,5114,219918,446,16680,482,17236,36,0.704
GA,Douglas County,44581,2624737,5832,259275,6146,246640,314,0.704
PA,Cumberland County,100036,8102192,6568,416279,7272,422643,704,0.704
AL,Henry County,5423,369684,403,15874,441,18723,38,0.701
MN,Traverse County,1285,74195,66,3499,75,2780,9,0.7
GA,Clayton County,88128,3351095,13018,416528,13634,400093,616,0.699
NM,Lincoln County,6869,355920,590,28527,638,41803,48,0.699
MI,Newaygo County,16906,918224,1255,50016,1373,66265,118,0.698
MI,Leelanau County,9178,817581,778,45447,842,108240,64,0.697
MI,Luce County,2008,98538,86,3532,100,4685,14,0.697
TN,Anderson County,26576,1643811,2361,110876,2546,117989,185,0.696
TX,San Saba County,1868,96207,112,4640,125,6532,13,0.696
AL,Shelby County,71240,6883125,6059,421656,6554,419442,495,0.695
SD,Miner County,864,47898,30,1696,36,1480,6,0.694
WI,Lincoln County,11550,659114,618,30590,698,33269,80,0.693
NC,Davie County,15019,1171960,1029,63571,1133,70038,104,0.692
TN,Henderson County,9136,451933,510,17509,573,21262,63,0.69
GA,Dade County,4643,252501,359,17201,391,17362,32,0.689
KY,Larue County,4798,236835,371,13585,404,14669,33,0.688
MO,Monroe County,3061,149896,212,8282,233,8045,21,0.686
NC,Rockingham County,31670,1659816,1578,66782,1795,78803,217,0.685
OH,Clermont County,76483,5785670,5321,335391,5843,327854,522,0.683
SC,Cherokee County,17862,884022,1013,36954,1135,43235,122,0.683
AR,Greene County,13329,746478,923,40080,1014,35199,91,0.683
KY,Hardin County,37070,2239849,3474,169880,3727,171213,253,0.682
VA,Amelia County,4836,286419,318,13375,351,16736,33,0.682
IL,Scott County,1907,113752,95,3316,108,3717,13,0.682
NE,Hamilton County,3538,274230,230,11803,254,15817,24,0.678
TN,Wayne County,4579,211430,222,6809,253,11177,31,0.677
SD,McCook County,2070,135214,121,5390,135,6411,14,0.676
WI,Buffalo County,5344,281988,283,12005,319,13067,36,0.674
KY,Anderson County,8306,494447,612,27138,668,29350,56,0.674
MI,Cass County,18169,1253271,1419,72838,1541,96225,122,0.671
AL,Geneva County,7763,365052,535,22327,587,24270,52,0.67
TN,Knox County,162444,13197680,11333,672111,12420,718271,1087,0.669
MS,Stone County,5082,254175,387,16948,421,17835,34,0.669
TX,Hardin County,18251,1310559,1461,91692,1583,115626,122,0.668
TX,Martin County,1647,191313,142,12287,153,8563,11,0.668
NE,Howard County,2400,124888,128,5180,144,7391,16,0.667
VA,Grayson County,4956,220241,302,11301,335,11586,33,0.666
KS,Washington County,2252,116166,80,3404,95,3444,15,0.666
TN,Scott County,6329,281831,189,6033,231,9461,42,0.664
TX,Goliad County,2411,161066,176,9733,192,11355,16,0.664
KY,Garrard County,5287,280226,484,21125,519,23616,35,0.662
KY,Trigg County,4697,233654,314,14514,345,19969,31,0.66
TX,Shackelford County,1060,77663,96,3880,103,4643,7,0.66
MA,Barnstable County,100287,8471195,5535,452658,6196,719738,661,0.659
PA,Butler County,74803,6506711,3943,286863,4435,347128,492,0.658
AR,Crawford County,18410,979041,1445,53766,1566,61020,121,0.657
WI,Green Lake County,7492,426776,520,23420,569,30692,49,0.654
TX,Collingsworth County,922,45022,45,1978,51,2073,6,0.651
SC,Laurens County,20747,1003070,1438,55748,1573,64663,135,0.651
OK,Coal County,1541,76390,112,4555,122,4500,10,0.649
TX,Delta County,1543,76213,146,5886,156,6883,10,0.648
FL,Holmes County,5118,228295,428,15004,461,19636,33,0.645
IL,Menard County,4803,348553,329,15717,360,17749,31,0.645
GA,Monroe County,8688,675384,774,39207,830,52043,56,0.645
MO,Mercer County,1242,47502,41,2064,49,2175,8,0.644
AL,Chilton County,13372,713099,782,31426,868,37423,86,0.643
ID,Owyhee County,3427,137312,383,13935,405,19528,22,0.642
ID,Elmore County,8573,400112,1253,59301,1308,53719,55,0.642
KY,Bath County,3585,159146,239,8102,262,9598,23,0.642
KY,Marshall County,11055,682537,671,27348,742,33788,71,0.642
NE,Valley County,1562,60263,70,2982,80,2083,10,0.64
WI,Rusk County,5309,254064,305,11472,339,15202,34,0.64
MI,Grand Traverse County,37887,2901462,2763,148289,3005,206260,242,0.639
CA,San Joaquin County,244304,16385896,13440,768131,15000,895331,1560,0.639
WA,Snohomish County,297851,26359026,22054,1544592,23954,1736697,1900,0.638
MO,Webster County,11765,631691,981,38429,1056,45236,75,0.637
GA,Camden County,16179,925321,2163,98699,2266,105267,103,0.637
TN,Hawkins County,18399,918830,1253,47805,1370,58596,117,0.636
TN,Carroll County,8995,440084,622,22200,679,27246,57,0.634
VA,Mecklenburg County,10747,544911,622,30807,690,37524,68,0.633
MO,Taney County,18346,826502,1862,65510,1978,92762,116,0.632
OH,Logan County,17869,1035313,1039,44945,1152,56278,113,0.632
MN,Scott County,52792,5670994,4615,346920,4948,354915,333,0.631
MN,Crow Wing County,24712,1580842,1638,84283,1794,115102,156,0.631
WI,Pepin County,2860,186643,185,8375,203,9231,18,0.629
OR,Polk County,26924,1914624,3053,154119,3222,149562,169,0.628
IL,Monroe County,13711,1230324,734,58124,820,61008,86,0.627
WA,Walla Walla County,20276,1382349,1367,68826,1493,88856,126,0.621
MI,Presque Isle County,5160,264303,269,10829,301,15804,32,0.62
TX,Smith County,76284,5557527,5513,284065,5985,330219,472,0.619
AR,Lonoke County,22623,1430803,2176,103437,2316,101804,140,0.619
MN,Pine County,10020,546187,728,30971,790,39059,62,0.619
IN,Clay County,9384,511923,646,25509,704,29296,58,0.618
AR,Grant County,5670,372460,395,16115,430,18874,35,0.617
UT,Millard County,3888,218373,205,10934,229,10134,24,0.617
MO,Pulaski County,12645,637122,2492,124108,2570,117851,78,0.617
WI,Jackson County,7464,413601,460,20279,506,22773,46,0.616
AL,Cullman County,26631,1560602,1326,57170,1490,77215,164,0.616
MI,Charlevoix County,10570,750679,767,45128,832,74289,65,0.615
WI,Columbia County,23564,1724514,1915,101886,2060,108980,145,0.615
TN,Grundy County,4408,186862,248,9762,275,13414,27,0.613
NE,Saunders County,7843,602478,595,31876,643,44666,48,0.612
KS,Johnson County,223074,25929982,16761,1299257,18127,1191520,1366,0.612
MI,Barry County,22409,1561133,1668,84905,1805,105736,137,0.611
NH,Sullivan County,17082,1244456,1176,60448,1280,90884,104,0.609
NJ,Ocean County,226861,16957981,11215,774957,12595,954469,1380,0.608
MD,Cecil County,36332,2621910,2494,149379,2713,141380,219,0.603
OK,Grady County,16263,1167816,1375,64779,1473,80317,98,0.603
AR,Washington County,73592,5305239,6325,332130,6769,377014,444,0.603
FL,Duval County,344842,22418910,26620,1543259,28682,1636159,2062,0.598
ME,Cumberland County,121235,10726185,8137,527263,8861,629612,724,0.597
OK,Pawnee County,4690,255202,418,16357,446,18469,28,0.597
TX,Madison County,3869,222741,270,11311,293,13064,23,0.594
CO,Kit Carson County,2541,100401,178,7257,193,9878,15,0.59
IN,Clark County,43898,2658733,3443,167010,3702,173444,259,0.59
TX,Panola County,7634,475473,478,22943,523,24339,45,0.589
NH,Strafford County,48732,3658635,4053,249947,4340,270876,287,0.589
TX,Rusk County,15686,936189,1234,52676,1326,66724,92,0.587
IN,Steuben County,12791,800797,915,45506,990,67187,75,0.586
IN,Switzerland County,3254,157453,227,9548,246,11523,19,0.584
AL,Marion County,8393,407247,542,19862,591,21494,49,0.584
MI,Oceana County,9442,501563,691,32287,746,35602,55,0.583
NH,Belknap County,25725,2046114,2076,131642,2226,203653,150,0.583
SC,Abbeville County,7563,374968,465,19594,509,20849,44,0.582
MN,Mille Lacs County,9273,486950,858,40794,912,44033,54,0.582
MO,Chariton County,2754,141016,125,4936,141,5576,16,0.581
TX,Milam County,8090,431278,611,24910,658,32857,47,0.581
IA,Adair County,2761,149122,151,5757,167,6431,16,0.58
IN,Warrick County,22941,2081618,1741,105982,1874,118067,133,0.58
MO,Polk County,9479,484861,805,29238,860,33153,55,0.58
KY,Nelson County,17301,1077503,980,45472,1080,48163,100,0.578
CA,Del Norte County,7650,405135,533,24141,577,28615,44,0.575
ID,Power County,2433,101425,175,7208,189,7106,14,0.575
MN,Anoka County,135802,10981539,10887,640364,11667,603814,780,0.574
ND,Oliver County,702,48879,42,2755,46,3076,4,0.57
IN,Morgan County,26081,1727418,2060,103343,2208,110241,148,0.567
AR,Johnson County,7603,351662,512,18976,555,20700,43,0.566
TX,Washington County,12232,850201,822,40875,891,60850,69,0.564
GA,Fulton County,373518,44050557,46808,3543949,48914,3813753,2106,0.564
MI,Clinton County,28549,2235809,2456,125913,2617,142627,161,0.564
NC,Cleveland County,32516,1711981,1876,72256,2059,81015,183,0.563
KY,Hart County,5877,246282,343,11079,376,13312,33,0.562
ID,Lemhi County,2855,136056,191,6889,207,11612,16,0.56
KY,Taylor County,8070,399012,496,20046,541,19773,45,0.558
WY,Sheridan County,11819,995300,834,45353,900,51367,66,0.558
TN,Carter County,18013,844519,1321,43189,1421,54932,100,0.555
MO,Newton County,18387,1117888,1696,73052,1798,76016,102,0.555
TX,Lavaca County,7204,482365,438,20123,478,28882,40,0.555
ID,Bingham County,14284,785072,1018,43334,1097,50485,79,0.553
TX,Swisher County,2174,105432,159,8005,171,4078,12,0.552
MO,Lewis County,3263,164785,205,6211,223,9047,18,0.552
ID,Bannock County,27100,1618652,1880,82792,2029,90515,149,0.55
IL,Kendall County,43559,3764550,4392,291445,4631,291977,239,0.549
MN,Morrison County,12587,707442,739,34347,808,42690,69,0.548
NC,Rowan County,48391,2658562,3208,134407,3473,155549,265,0.548
VA,Gloucester County,14409,975115,1046,53432,1125,66238,79,0.548
IN,Ohio County,2192,124650,159,7227,171,8325,12,0.547
GA,Carroll County,34993,2262293,2974,132952,3165,152347,191,0.546
NC,Catawba County,56589,3665813,3799,198895,4106,219069,307,0.543
NC,Alleghany County,3690,199759,185,9808,205,10505,20,0.542
TX,Howard County,9818,729510,808,43218,861,42394,53,0.54
VA,Warren County,14631,983113,1287,74125,1366,83004,79,0.54
KY,Oldham County,20738,2594029,1777,173802,1889,181105,112,0.54
TX,Hopkins County,11857,644538,860,34716,924,44542,64,0.54
IA,Polk County,179333,15111284,12375,746798,13343,758910,968,0.54
GA,Heard County,3168,185811,265,9745,282,10739,17,0.537
IA,Madison County,5638,449048,453,24230,483,30662,30,0.532
KY,Jackson County,3573,148446,167,5254,186,6900,19,0.532
KS,Smith County,1508,66287,50,1521,58,1946,8,0.531
NM,Lea County,20946,1333248,1221,66929,1332,59162,111,0.53
TN,Hamilton County,128083,9905434,8094,456723,8772,560766,678,0.529
IN,Whitley County,13259,916344,871,40142,941,46818,70,0.528
IN,Tipton County,5878,383716,442,19346,473,21745,31,0.527
GA,Appling County,5508,271497,291,11108,320,10695,29,0.527
MO,Jefferson County,83014,5248960,5038,266756,5474,272203,436,0.525
GA,Bleckley County,3641,197488,238,9408,257,9022,19,0.522
OR,Malheur County,8235,383662,616,24091,659,23240,43,0.522
RI,Bristol County,18784,2357316,1317,141968,1415,122626,98,0.522
OR,Baker County,5565,274088,369,15241,398,17750,29,0.521
MS,Pearl River County,16311,860103,1100,47488,1185,53265,85,0.521
WV,Summers County,3485,154113,200,6737,218,8442,18,0.516
ID,Idaho County,5065,249783,365,14320,391,22230,26,0.513
CO,La Plata County,20718,1740363,1898,112022,2004,140391,106,0.512
MO,Schuyler County,1367,53923,92,3058,99,3583,7,0.512
WA,Okanogan County,14379,757710,895,40611,968,50237,73,0.508
WI,Marinette County,16198,868370,991,45186,1073,48609,82,0.506
VA,Southampton County,5931,345499,410,17618,440,18168,30,0.506
NE,Merrick County,2768,152963,168,7567,182,8567,14,0.506
VA,Patrick County,5926,283562,277,11046,307,11191,30,0.506
UT,Carbon County,6142,352992,391,16419,422,16382,31,0.505
MO,DeKalb County,3169,164504,274,10392,290,10902,16,0.505
KS,Jewell County,1196,54306,41,1104,47,1607,6,0.502
MO,Laclede County,11804,545060,742,30410,801,28794,59,0.5
IN,Porter County,63902,5240688,4332,244133,4651,275448,319,0.499
IL,Jasper County,3806,220675,125,4710,144,5732,19,0.499
IL,Grundy County,19294,1536201,1564,102107,1660,86465,96,0.498
NC,Burke County,29713,1523282,1772,71901,1920,83117,148,0.498
TX,Gaines County,5837,357624,360,20743,389,19482,29,0.497
KS,Harper County,2022,97478,95,3787,105,3399,10,0.495
WV,Jefferson County,20192,1547589,1702,109523,1802,111099,100,0.495
HI,Hawaii County,70835,4351974,3653,199739,4003,259449,350,0.494
MD,Howard County,116264,15233847,11536,953048,12106,908741,570,0.49
TX,Hardeman County,1224,50446,70,2896,76,2649,6,0.49
WI,Juneau County,9861,507664,710,27521,758,35520,48,0.487
NC,Mecklenburg County,375430,37313508,34327,2511245,36156,2658138,1829,0.487
AR,Carroll County,9453,439753,650,23117,696,31911,46,0.487
VT,Franklin County,19902,1223621,1138,57394,1235,58035,97,0.487
SC,Newberry County,12778,687796,673,31993,735,38029,62,0.485
AL,Tallapoosa County,13425,714031,871,41928,936,55021,65,0.484
CO,Routt County,9940,1069506,1007,66256,1055,89085,48,0.483
TN,Rhea County,10382,521559,685,28407,735,35832,50,0.482
SC,Charleston County,141710,13535232,14449,884980,15130,1354657,681,0.481
TN,Pickett County,1668,91388,114,6201,122,7706,8,0.48
MS,Rankin County,50963,3499630,3619,196182,3863,195023,244,0.479
KS,Wabaunsee County,2517,151395,137,6503,149,7746,12,0.477
VA,Hanover County,40270,3771914,3099,196821,3290,216460,191,0.474
NH,Rockingham County,129670,13621666,9769,837564,10379,882097,610,0.47
NY,Sullivan County,26581,1614140,1780,96528,1905,100167,125,0.47
MI,Emmet County,13686,1027354,989,71593,1053,97656,64,0.468
MO,Ray County,8212,489557,646,28094,684,31849,38,0.463
MS,Choctaw County,2591,118933,159,5628,171,7125,12,0.463
NE,Garfield County,650,29650,33,2338,36,1020,3,0.462
OR,Washington County,214549,20931809,19016,1353351,20005,1325403,989,0.461
KY,Menifee County,1766,72607,113,2947,121,4624,8,0.453
GA,Lee County,9948,695970,1070,56542,1115,51556,45,0.452
IA,Delaware County,6661,393378,319,14583,349,16718,30,0.45
MI,Ontonagon County,2232,103646,91,3559,101,4970,10,0.448
IA,Clayton County,6920,388860,335,12586,366,17395,31,0.448
OK,Lincoln County,10277,547155,911,37880,957,48713,46,0.448
NC,Hyde County,1565,71639,73,3114,80,3094,7,0.447
OH,Medina County,72172,5942980,4539,275281,4860,308859,321,0.445
TN,Giles County,10112,525581,702,29114,747,36238,45,0.445
NY,Greene County,17816,1119117,1172,57403,1251,77814,79,0.443
MS,Madison County,37142,3416547,3194,215953,3358,244610,164,0.442
NC,New Hanover County,76363,6112267,7427,388000,7763,523026,336,0.44
ME,Waldo County,14846,814885,1039,46800,1104,56847,65,0.438
OK,Pottawatomie County,21803,1187180,1654,66849,1749,68997,95,0.436
MI,Menominee County,8959,530668,459,18541,498,22254,39,0.435
VA,Charles City County,2767,170732,167,7735,179,11729,12,0.434
ID,Washington County,3233,146637,270,10155,284,14129,14,0.433
VA,Lancaster County,4628,347227,271,16487,291,26732,20,0.432
FL,Seminole County,163866,12591524,19014,1056393,19718,1043750,704,0.43
GA,Montgomery County,2323,119153,206,7956,216,6975,10,0.43
TN,Lincoln County,11940,649652,742,31376,793,40461,51,0.427
IA,Bremer County,8900,679615,569,28138,607,29971,38,0.427
WI,Calumet County,19029,1546041,1593,96000,1674,101818,81,0.426
TX,Randall County,45684,3609729,4791,245881,4985,257519,194,0.425
WA,Chelan County,29250,2123481,2351,125535,2475,160149,124,0.424
PA,Washington County,82362,6924404,3942,286149,4291,284630,349,0.424
WI,Washington County,55490,4724803,3343,205382,3576,225990,233,0.42
KY,Boone County,45535,3790379,4641,291704,4832,263576,191,0.419
OK,Tillman County,2146,93223,134,6829,143,5079,9,0.419
WI,Chippewa County,24756,1593830,1614,71850,1717,89599,103,0.416
KS,Osage County,5792,316223,439,17403,463,18913,24,0.414
MS,Tishomingo County,5801,290717,315,11841,339,12121,24,0.414
KY,Lewis County,3880,176202,187,6831,203,6137,16,0.412
VT,Orange County,11886,735616,865,40956,914,45214,49,0.412
AL,Marshall County,30376,1731420,1907,75711,2032,93034,125,0.412
MO,Clinton County,7306,464578,732,35342,762,36100,30,0.411
OK,Atoka County,3907,185385,258,9810,274,10666,16,0.41
KY,Madison County,27678,1668343,2406,106678,2519,116549,113,0.408
VA,Roanoke County,35790,2867149,3316,179856,3462,191542,146,0.408
IN,Jefferson County,11558,674626,657,29100,704,27664,47,0.407
AL,Walker County,19713,1160234,907,38323,987,41789,80,0.406
CO,Jackson County,493,23663,22,754,24,1073,2,0.406
FL,Palm Beach County,553857,61273140,35233,2953481,37476,5417837,2243,0.405
KY,Laurel County,18540,943972,1157,42256,1232,49268,75,0.405
IN,DeKalb County,16289,1008141,1125,51108,1191,49491,66,0.405
WI,Dodge County,34122,2154396,2363,127966,2501,119032,138,0.404
MN,Mahnomen County,1741,85663,101,3920,108,3970,7,0.402
NC,Perquimans County,4484,260300,396,14481,414,20831,18,0.401
TN,Warren County,13261,626587,740,27305,793,30071,53,0.4
NY,Saratoga County,92707,10060047,6895,655521,7266,780689,371,0.4
MS,Franklin County,2508,143591,134,5412,144,7006,10,0.399
GA,Baldwin County,12853,668214,868,34261,919,43487,51,0.397
SC,Chesterfield County,14145,630352,663,28243,719,30269,56,0.396
VT,Essex County,2279,101084,177,5280,186,7537,9,0.395
ME,Androscoggin County,39357,2179122,2525,115960,2680,113106,155,0.394
MO,Osage County,4850,469655,234,8811,253,10280,19,0.392
NC,Northampton County,6131,272670,392,11946,416,14457,24,0.391
RI,Kent County,69664,5663811,4946,337173,5218,316999,272,0.39
TN,Washington County,43581,2843658,3678,199787,3848,193422,170,0.39
IN,Noble County,17214,977139,1218,53217,1285,57369,67,0.389
GA,Marion County,2059,95463,155,6067,163,5803,8,0.389
GA,Brantley County,4901,222414,355,11639,374,12369,19,0.388
NE,Butler County,3124,186293,162,7372,174,8360,12,0.384
NE,Nemaha County,2350,153961,140,7350,149,6443,9,0.383
IN,Henry County,17240,908640,1065,44151,1131,45658,66,0.383
IL,Johnson County,3938,222997,244,10686,259,18960,15,0.381
AR,Hot Spring County,9485,486580,717,26088,753,29374,36,0.38
MT,Carbon County,3967,243889,333,13986,348,23750,15,0.378
MD,Harford County,98171,8610040,6332,424867,6702,416096,370,0.377
MO,Franklin County,39465,2560544,2163,97128,2311,121518,148,0.375
VT,Orleans County,11220,546189,540,23471,582,34300,42,0.374
WI,Vernon County,10970,592828,659,27835,700,33542,41,0.374
PA,Monroe County,60121,3684696,4283,213540,4506,250461,223,0.371
MO,Ste. Genevieve County,6515,407677,412,18019,436,18250,24,0.368
MN,Becker County,12484,824855,808,42514,854,47628,46,0.368
KY,Montgomery County,8965,484109,683,25859,716,27478,33,0.368
KS,Miami County,11694,933051,973,52636,1016,66103,43,0.368
MO,St. Charles County,150687,12896086,9825,641975,10378,659764,553,0.367
AR,Craighead County,32462,2108035,2526,106905,2645,112980,119,0.367
OK,Cleveland County,91219,6910365,8904,424981,9239,444358,335,0.367
ME,Franklin County,10371,529577,685,33849,723,36060,38,0.366
IN,Shelby County,16679,1035640,1149,52665,1210,52382,61,0.366
KS,Kingman County,2736,148599,181,16685,191,8596,10,0.365
IA,Ringgold County,1647,77506,81,3015,87,4728,6,0.364
AL,Blount County,17300,982763,1148,51327,1211,52661,63,0.364
AL,Etowah County,33042,1743402,1675,64519,1795,76285,120,0.363
IN,Owen County,7459,386475,568,22948,595,25855,27,0.362
MO,Cooper County,5810,300566,415,15741,436,18938,21,0.361
MN,Dodge County,7792,574781,542,27985,570,27338,28,0.359
GA,Floyd County,30554,1865901,1790,99242,1899,81521,109,0.357
NC,Caldwell County,26870,1369394,1521,60709,1617,74226,96,0.357
IA,Buchanan County,7562,473578,410,17968,437,19341,27,0.357
WV,Braxton County,4214,207685,175,7144,190,7228,15,0.356
NE,Franklin County,1125,53532,54,2204,58,2083,4,0.356
KY,Franklin County,19421,1166722,1421,63642,1490,62637,69,0.355
KY,Carlisle County,1691,89943,81,2527,87,3519,6,0.355
MO,Ozark County,2818,108346,197,5693,207,9838,10,0.355
MO,Vernon County,6502,301024,425,15901,448,15084,23,0.354
MN,Goodhue County,18661,1388802,1189,67546,1255,70915,66,0.354
AL,Greene County,2549,95056,135,4423,144,4688,9,0.353
VA,Washington County,17959,1134696,1122,52299,1185,55991,63,0.351
PA,Tioga County,15100,855715,699,33019,752,37223,53,0.351
GA,Fayette County,39298,4328896,3983,315298,4120,320777,137,0.349
IN,Fayette County,8067,392389,400,17589,428,15294,28,0.347
OK,Ottawa County,9509,416241,655,24972,688,22541,33,0.347
KY,Casey County,4626,186580,261,11207,277,9588,16,0.346
VA,Northampton County,4623,277456,268,12488,284,21501,16,0.346
VA,Shenandoah County,16565,998054,1132,58619,1189,61418,57,0.344
MD,Anne Arundel County,217992,22622741,18828,1386775,19576,1342872,748,0.343
VA,Page County,8745,442823,388,17784,418,18408,30,0.343
KS,Butler County,22244,1677009,1791,108648,1867,101193,76,0.342
OK,Love County,3215,167052,303,12045,314,11659,11,0.342
MI,Muskegon County,62076,3380386,3080,134139,3290,159541,210,0.338
KY,Washington County,4141,216418,286,9213,300,11113,14,0.338
MD,Wicomico County,35135,2100913,2415,117676,2533,101091,118,0.336
IL,Piatt County,6276,485942,448,23947,469,28450,21,0.335
GA,Irwin County,2731,135086,209,6028,218,7071,9,0.33
IN,Fountain County,6111,320647,427,18333,447,18603,20,0.327
TX,Edwards County,612,35212,46,2043,48,3050,2,0.327
TX,Stephens County,2759,140533,158,6954,167,8076,9,0.326
ID,Nez Perce County,14425,890556,1136,47190,1183,52487,47,0.326
OH,Perry County,12018,631570,781,31527,820,34758,39,0.325
ND,Hettinger County,927,54090,39,2171,42,1822,3,0.324
MN,Douglas County,15146,1098044,943,42548,992,74016,49,0.324
MT,Yellowstone County,61209,4466111,3464,187045,3662,192899,198,0.323
MI,Sanilac County,15185,778613,866,39051,915,40376,49,0.323
WI,Walworth County,38483,2792024,2874,151325,2998,185945,124,0.322
WI,Monroe County,17112,963042,1195,58761,1250,57030,55,0.321
TX,Bexar County,674412,44427764,38604,2387824,40760,2308578,2156,0.32
MA,Plymouth County,204025,21041244,11602,1006256,12253,994861,651,0.319
AR,Madison County,5041,239750,392,15007,408,17487,16,0.317
NC,Pasquotank County,13342,691106,1203,52719,1245,52915,42,0.315
MO,Texas County,7302,295279,536,18238,559,21763,23,0.315
OR,Morrow County,3499,199388,288,12662,299,12378,11,0.314
KY,Powell County,3816,163692,258,8822,270,10021,12,0.314
NC,Stokes County,15719,853929,1020,40995,1069,46514,49,0.312
CA,Shasta County,60488,3889602,3822,203017,4010,205471,188,0.311
GA,Johnson County,2251,95293,134,4181,141,4464,7,0.311
KY,Boyle County,9366,559588,791,34256,820,33812,29,0.31
KY,Kenton County,59416,5028508,5475,322682,5659,290914,184,0.31
FL,Madison County,5510,250580,308,13106,325,13034,17,0.309
CO,Dolores County,649,30831,34,1615,36,1797,2,0.308
OK,Washita County,3276,163479,303,12104,313,11239,10,0.305
KY,Caldwell County,4266,214963,255,11352,268,10832,13,0.305
WV,Putnam County,20077,1481471,1404,75288,1465,78374,61,0.304
OR,Harney County,2321,103106,156,7181,163,6842,7,0.302
CA,Sacramento County,544229,39224971,31738,1974737,33378,1904425,1640,0.301
AZ,Yuma County,66043,3245893,4238,200681,4436,206184,198,0.3
SD,Hutchinson County,2687,154240,145,6565,153,7087,8,0.298
WV,Mason County,8383,427696,415,18407,440,16775,25,0.298
KY,Nicholas County,2361,102461,130,3662,137,4803,7,0.296
ID,Minidoka County,6754,331649,496,25900,516,21404,20,0.296
MO,Howell County,12496,591983,772,24253,809,30748,37,0.296
IN,Vermillion County,5766,303632,343,11994,360,12661,17,0.295
SD,Yankton County,8478,601635,560,24515,585,28949,25,0.295
MT,Teton County,2399,122337,128,5048,135,5546,7,0.292
WI,Barron County,18569,1100901,1041,44735,1095,52694,54,0.291
MI,Gladwin County,8929,453520,689,31288,715,39791,26,0.291
MI,Branch County,14784,804308,962,40544,1005,46466,43,0.291
GA,Hancock County,2419,95510,157,5852,164,7353,7,0.289
GA,Chatham County,92292,6463149,9683,493564,9949,516450,266,0.288
MT,Missoula County,44498,3477133,3743,164579,3871,198535,128,0.288
NC,Surry County,24058,1337036,1179,48310,1248,52969,69,0.287
UT,Sevier County,6305,377842,422,16782,440,19826,18,0.285
NC,Forsyth County,132514,10000050,9288,581552,9666,552456,378,0.285
VA,Madison County,4934,273487,307,15182,321,19960,14,0.284
UT,Morgan County,3537,420195,322,22477,332,32304,10,0.283
VT,Windsor County,24027,1684536,1797,100846,1865,125704,68,0.283
PA,Wayne County,19535,1183064,1257,65402,1312,76437,55,0.282
MI,Arenac County,5697,279378,404,14241,420,18218,16,0.281
NC,Vance County,14591,668400,892,31811,933,31676,41,0.281
OK,Carter County,15671,1005459,1037,46318,1081,45094,44,0.281
HI,Maui County,64891,4314680,3190,194331,3372,295788,182,0.28
PA,Chester County,197338,26734776,11842,1215432,12392,1186103,550,0.279
TX,Cherokee County,15800,907643,1020,49153,1064,56935,44,0.278
TN,Polk County,5402,262313,418,15644,433,18624,15,0.278
MI,Monroe County,58614,4013967,3317,179202,3480,182330,163,0.278
TX,Austin County,10483,788057,763,45361,792,54327,29,0.277
OH,Richland County,45689,2519274,2269,98881,2394,101289,125,0.274
MI,Ottawa County,102877,8410444,7084,383581,7366,468685,282,0.274
WI,Kenosha County,63550,4321225,4166,225256,4340,222691,174,0.274
WV,Upshur County,8039,413023,388,17227,410,16453,22,0.274
GA,Jones County,9153,548610,643,26359,668,27732,25,0.273
MD,Washington County,54762,3554116,3437,171845,3586,180535,149,0.272
SC,Colleton County,12913,584421,834,34601,869,37249,35,0.271
KY,Russell County,5528,241412,304,12935,319,13018,15,0.271
ME,Kennebec County,46913,2784631,2865,147700,2991,145222,126,0.269
CA,Madera County,46157,2499212,2721,130006,2845,154806,124,0.269
MI,Montcalm County,21559,1073714,1683,83744,1741,77281,58,0.269
MN,Wadena County,4827,258105,410,16346,423,17297,13,0.269
PA,Northampton County,120678,9315273,7762,464493,8085,506568,323,0.268
CA,Merced County,80967,4183073,4442,197093,4658,198361,216,0.267
MO,Oregon County,3006,116605,202,6050,210,8192,8,0.266
GA,Rockdale County,27932,1533576,3803,160067,3877,144258,74,0.265
CA,Sutter County,31241,1936203,2437,115705,2518,107607,81,0.259
NM,Mora County,1555,56658,84,2617,88,3086,4,0.257
WI,Washburn County,6647,401859,479,26225,496,30558,17,0.256
SD,Turner County,3158,192565,188,8591,196,10131,8,0.253
IN,LaPorte County,40662,2385776,2111,130364,2214,128768,103,0.253
NC,Guilford County,183536,13364580,13363,725995,13828,744253,465,0.253
VA,Northumberland County,4759,326304,322,17780,334,24293,12,0.252
NC,Wilson County,27433,1466500,1605,75464,1674,67198,69,0.252
WI,Rock County,63473,4366492,3265,181997,3423,164280,158,0.249
NE,Harlan County,1212,58819,63,2546,66,2534,3,0.248
MO,Andrew County,6452,435672,548,29469,564,28116,16,0.248
FL,Liberty County,2014,96170,136,4350,141,4354,5,0.248
TX,Travis County,431303,49131355,47553,3238771,48623,3884317,1070,0.248
AL,Crenshaw County,4462,205376,267,9794,278,10806,11,0.247
OK,Stephens County,13451,888084,817,36248,850,35017,33,0.245
TX,Hartley County,1227,78393,138,7818,141,7292,3,0.244
VA,Carroll County,9894,464710,566,18749,590,24767,24,0.243
MD,St. Mary's County,40656,3589778,3204,218529,3302,192347,98,0.241
KS,Sherman County,2078,110621,118,4544,123,4677,5,0.241
SD,Deuel County,1663,93003,62,3969,66,3433,4,0.241
MO,Bollinger County,3770,170013,253,9045,262,9519,9,0.239
NC,Avery County,5492,272973,416,23777,429,28065,13,0.237
TX,McLennan County,82578,5109999,5191,252360,5386,298604,195,0.236
OH,Guernsey County,14400,799354,696,27841,730,31787,34,0.236
TN,Tipton County,20564,1184755,1454,63820,1502,68402,48,0.233
SC,Union County,8661,373024,381,13773,401,13980,20,0.231
NC,Randolph County,49144,2779124,2825,120648,2938,119207,113,0.23
TX,Brown County,12303,689549,840,34739,868,42395,28,0.228
AL,Covington County,11559,621953,575,23405,601,24234,26,0.225
IN,Warren County,3116,192736,194,9772,201,10418,7,0.225
VA,Prince George County,11142,771324,1866,90978,1891,90159,25,0.224
MS,Wilkinson County,2725,109434,128,4195,134,7595,6,0.22
VA,Floyd County,5451,294895,298,12672,310,16481,12,0.22
SC,Dillon County,9577,374017,426,13708,447,13661,21,0.219
UT,Uintah County,9698,601580,714,36417,735,33899,21,0.217
TX,Tarrant County,706539,62451120,52368,3365597,53903,3295717,1535,0.217
GA,Clinch County,1854,85979,114,4792,118,3121,4,0.216
MI,Mason County,11172,617086,661,42877,685,35274,24,0.215
WI,Shawano County,15787,874686,1000,41322,1034,47863,34,0.215
OH,Hocking County,9823,503217,607,25246,628,25431,21,0.214
KY,Wolfe County,1865,72166,107,3560,111,3710,4,0.214
IL,Franklin County,13164,687461,726,29408,754,27507,28,0.213
TX,Glasscock County,471,110852,35,3070,36,2245,1,0.212
WI,Ozaukee County,36095,4772249,2450,219707,2526,227290,76,0.211
WI,Waukesha County,163295,18000254,10367,782159,10709,807121,342,0.209
ME,Knox County,16269,1061882,968,48161,1002,73722,34,0.209
KY,Mercer County,7702,412319,512,21718,528,22477,16,0.208
SC,Saluda County,6255,319868,415,16493,428,19630,13,0.208
OH,Lake County,98642,6804740,4686,260244,4891,258550,205,0.208
CA,Solano County,161614,12446243,12055,731834,12390,746168,335,0.207
TX,Briscoe County,484,25308,24,801,25,1339,1,0.207
AL,Autauga County,18028,1143227,1888,99955,1925,100564,37,0.205
WI,Fond du Lac County,40884,2847571,2247,115930,2331,112550,84,0.205
TX,Harrison County,21578,1306959,1749,84448,1793,88924,44,0.204
NJ,Warren County,41840,3419739,2980,195712,3065,186551,85,0.203
OH,Jackson County,10825,509950,499,18143,521,20775,22,0.203
IN,Lawrence County,16848,911201,794,33849,828,33751,34,0.202
GA,Taliaferro County,498,18189,30,613,31,1013,1,0.201
OR,Union County,8955,527331,587,23807,605,28460,18,0.201
IL,Clay County,4992,254871,249,9240,259,9636,10,0.2
KY,Butler County,4001,193669,216,7770,224,7511,8,0.2
GA,Toombs County,8076,423717,579,23497,595,24536,16,0.198
SD,Roberts County,3540,184959,186,7083,193,9850,7,0.198
OH,Knox County,21787,1317016,1277,58851,1320,72010,43,0.197
MN,Big Stone County,2028,105405,96,4008,100,5123,4,0.197
PA,Montgomery County,327321,43232222,20487,1962690,21130,1671360,643,0.196
GA,Ware County,10321,510719,769,40407,789,26613,20,0.194
IN,Allen County,141172,9656640,6552,392110,6826,343372,274,0.194
TX,Newton County,3660,192524,325,15338,332,17096,7,0.191
VA,Henrico County,122922,10732691,11868,767239,12101,733010,233,0.19
KS,Leavenworth County,25383,1826649,3008,186414,3056,192464,48,0.189
KY,Owsley County,1059,38986,43,1137,45,1556,2,0.189
MS,Lee County,28765,2031944,1963,84783,2017,89658,54,0.188
WI,Richland County,6416,338805,364,14635,376,16226,12,0.187
WI,Sauk County,26263,1599653,1813,79408,1862,94711,49,0.187
SC,Pickens County,37944,2403659,3210,154765,3281,213195,71,0.187
VT,Lamoille County,10761,797328,805,55096,825,44997,20,0.186
WV,Tucker County,2688,128680,121,3992,126,5487,5,0.186
NC,Montgomery County,8592,448856,535,23347,551,30290,16,0.186
IN,Huntington County,14106,784184,840,38622,866,40240,26,0.184
MO,Butler County,13552,659135,844,31171,869,30568,25,0.184
TX,Reagan County,1092,84244,85,4862,87,4052,2,0.183
CO,Moffat County,4363,276815,395,21833,403,17196,8,0.183
KS,Logan County,1091,61163,59,2067,61,2498,2,0.183
CO,Rio Grande County,4401,223056,377,15940,385,18403,8,0.182
MO,Hickory County,2773,103665,268,9573,273,11227,5,0.18
OH,Marion County,22372,1154374,1107,49237,1147,46951,40,0.179
TX,Jasper County,10722,607845,849,36256,868,54362,19,0.177
MS,Tippah County,6981,319330,329,13749,341,10624,12,0.172
OH,Vinton County,4076,194430,240,7626,247,8984,7,0.172
NC,Nash County,33289,1871583,2475,98260,2532,100477,57,0.171
OK,Hughes County,3506,155948,269,11605,275,8619,6,0.171
PA,Lebanon County,55983,3589170,2875,148175,2971,151412,96,0.171
AL,Bullock County,2948,108587,175,5388,180,5131,5,0.17
WI,Douglas County,16461,973595,1032,46918,1060,47792,28,0.17
TN,Henry County,11209,567760,685,23028,704,32294,19,0.17
MA,Bristol County,219100,16411869,10412,677989,10780,634517,368,0.168
MO,Carter County,1817,72075,124,3545,127,3668,3,0.165
AL,Coffee County,15784,992433,1815,93905,1841,90762,26,0.165
OK,Le Flore County,13595,639730,864,29618,886,31341,22,0.162
IN,Howard County,32132,1878569,1824,83284,1876,76121,52,0.162
OR,Multnomah County,307398,25856434,29500,1986099,29991,1853087,491,0.16
GA,Crisp County,6236,290537,408,14020,418,16768,10,0.16
TX,La Salle County,1873,169336,115,4989,118,6935,3,0.16
AL,Fayette County,5003,239162,292,11361,300,11608,8,0.16
GA,Evans County,3146,152519,225,6006,230,6877,5,0.159
WV,Preston County,11392,602239,516,23198,534,25542,18,0.158
AR,Faulkner County,37422,2477199,3095,137232,3154,140359,59,0.158
NC,Bladen County,9544,435487,542,17993,557,18657,15,0.157
IA,Cass County,5091,284558,270,11191,278,12131,8,0.157
WV,Wayne County,12189,626934,732,27417,751,28213,19,0.156
AR,Logan County,6531,301943,441,15315,451,15740,10,0.153
WI,Waupaca County,20249,1227133,1264,60768,1295,61397,31,0.153
AR,Bradley County,3313,153802,171,6381,176,5337,5,0.151
MS,Winston County,5947,281059,264,8302,273,10452,9,0.151
IA,Jasper County,13373,863354,922,45881,942,45623,20,0.15
MD,Caroline County,11990,672894,863,37094,881,35642,18,0.15
PA,Adams County,41123,2797909,2480,129802,2541,138656,61,0.148
VA,Henry County,17550,830818,911,30667,937,34700,26,0.148
TX,Lubbock County,97730,6754798,6957,335452,7102,355917,145,0.148
TX,Morris County,4075,187181,332,12349,338,12428,6,0.147
MD,Somerset County,6799,323091,504,18077,514,20853,10,0.147
IN,Parke County,5471,288887,352,13552,360,15969,8,0.146
KY,Grayson County,8290,387772,490,17766,502,21028,12,0.145
MS,Tate County,9043,472808,662,28063,675,29510,13,0.144
WI,Outagamie County,73683,5679487,5474,322045,5580,294865,106,0.144
GA,Elbert County,6251,286631,338,14052,347,16675,9,0.144
SD,Meade County,10001,616050,1478,62615,1492,69967,14,0.14
MN,Pipestone County,3572,212049,182,7823,187,6929,5,0.14
IA,Wayne County,2178,115569,102,3962,105,3829,3,0.138
MN,Meeker County,8682,579252,573,27855,585,31859,12,0.138
IN,Fulton County,7362,421599,482,19293,492,18809,10,0.136
PA,York County,180335,12812391,8290,508243,8532,453941,242,0.134
NY,Washington County,22803,1241156,1521,63366,1551,61859,30,0.132
NC,Yadkin County,12900,719469,728,27682,745,27431,17,0.132
IL,Edwards County,2301,135994,126,4524,129,4215,3,0.13
WI,Jefferson County,32517,2165164,2435,120275,2477,221368,42,0.129
MN,Waseca County,7055,418888,479,20903,488,20545,9,0.128
IA,Woodbury County,36667,2251500,2159,108078,2206,79792,47,0.128
WV,Mineral County,10201,538191,484,19578,497,20605,13,0.127
NY,Ulster County,69500,4862689,4017,235835,4105,270903,88,0.127
NY,Franklin County,16527,901287,769,38229,790,38483,21,0.127
MN,Todd County,8637,444968,626,27138,637,30365,11,0.127
WV,Hampshire County,7909,391944,450,17646,460,21394,10,0.126
CO,Lincoln County,1588,80709,94,3974,96,4231,2,0.126
NC,Wilkes County,22264,1168714,902,38925,930,38543,28,0.126
WI,Iowa County,9608,615135,661,33814,673,37692,12,0.125
TX,Red River County,4001,189004,313,12492,318,13107,5,0.125
MS,Greene County,3260,168649,215,7866,219,7870,4,0.123
WI,Lafayette County,6488,376987,382,15934,390,16646,8,0.123
HI,Kauai County,28610,2144446,1377,77276,1412,100207,35,0.122
MS,Harrison County,65100,3559547,7495,300382,7574,323114,79,0.121
OK,Cimarron County,835,36051,22,949,23,938,1,0.12
IN,Lake County,179437,11420320,9978,469161,10193,488147,215,0.12
IA,Clarke County,3355,176801,247,11028,251,11152,4,0.119
PA,Franklin County,62269,3849548,2863,151141,2937,147209,74,0.119
CO,Arapahoe County,228665,22379567,31237,2080292,31510,2048018,273,0.119
MI,Allegan County,43304,2952051,3421,174848,3472,199987,51,0.118
IN,Orange County,6833,329306,361,14763,369,12836,8,0.117
OK,Mayes County,12156,661519,947,37727,961,42511,14,0.115
RI,Washington County,50579,4783286,3395,272559,3453,321507,58,0.115
NE,Furnas County,1761,83730,93,3241,95,3477,2,0.114
TN,Sevier County,34661,1784555,2991,115848,3029,140198,38,0.11
IN,Pulaski County,4567,254912,311,12506,316,10763,5,0.109
IA,Keokuk County,3663,192784,207,8456,211,7959,4,0.109
NC,Jackson County,12046,684304,1166,47866,1179,63487,13,0.108
MO,Lawrence County,12296,603286,1085,42552,1098,43720,13,0.106
KY,Rockcastle County,4742,213593,298,10114,303,10481,5,0.105
TN,Lewis County,3841,183217,264,9091,268,10649,4,0.104
AR,Boone County,11975,660747,838,32970,850,33112,12,0.1
NC,Warren County,6036,253499,449,15913,455,21660,6,0.099
NY,Clinton County,30466,1798988,1151,60913,1181,56075,30,0.098
OK,Craig County,4112,193451,327,13388,331,9836,4,0.097
CA,San Bernardino County,697466,42198055,47252,2453323,47926,2300220,674,0.097
MN,Itasca County,16557,1049823,791,39628,807,46373,16,0.097
UT,Summit County,16159,2829031,1808,195138,1823,433590,15,0.093
AL,Talladega County,25231,1282108,1638,72932,1661,70022,23,0.091
WI,Sheboygan County,47249,3263163,1987,112792,2030,103177,43,0.091
SD,Bon Homme County,2215,118190,113,5262,115,4299,2,0.09
FL,Gadsden County,15580,693817,1077,36610,1091,40002,14,0.09
NH,Cheshire County,29945,2173431,1915,117694,1942,119683,27,0.09
SD,Pennington County,42842,3003982,4569,234955,4607,265671,38,0.089
MI,Jackson County,56223,3430633,2802,155710,2851,138193,49,0.087
MO,Shelby County,2298,107507,95,2834,97,3480,2,0.087
TX,Limestone County,7019,348178,514,21714,520,23231,6,0.085
MI,Delta County,14156,794902,571,25783,583,25560,12,0.085
KY,Daviess County,35825,2241060,1636,79669,1666,76280,30,0.084
MI,Lenawee County,36200,2120869,1886,94370,1916,93679,30,0.083
WV,Randolph County,9782,492228,442,16114,450,22585,8,0.082
MN,McLeod County,14582,957427,934,50317,946,42672,12,0.082
KY,Harrison County,6210,330851,417,16655,422,17835,5,0.081
MD,Calvert County,34506,3363678,2543,188416,2571,187875,28,0.081
UT,Salt Lake County,394682,32171645,25040,1557230,25351,1516484,311,0.079
IL,Hardin County,1259,65745,43,1256,44,1296,1,0.079
NH,Hillsborough County,167702,15064886,11580,863493,11713,780878,133,0.079
WY,Big Horn County,3872,205563,262,12455,265,10411,3,0.077
KY,Logan County,9059,474195,557,19031,564,21481,7,0.077
IA,Marion County,11891,925276,726,38122,735,39768,9,0.076
MT,Gallatin County,42110,3616117,4842,247903,4874,308232,32,0.076
SC,Chester County,10809,503586,650,23945,658,28606,8,0.074
IN,Starke County,8123,415100,552,19833,558,22691,6,0.074
MA,Franklin County,28915,1886927,1782,116184,1803,84377,21,0.073
IL,Effingham County,13874,992355,657,34769,667,29061,10,0.072
MO,Audrain County,8417,424841,505,18255,511,17116,6,0.071
WI,Price County,5710,289682,325,14735,329,18807,4,0.07
TN,Weakley County,9969,514333,705,25271,712,25509,7,0.07
MO,Lafayette County,11630,665626,814,34745,822,34985,8,0.069
KY,Livingston County,3042,151253,259,9600,261,10014,2,0.066
KY,Campbell County,33253,2584463,2961,168908,2983,164798,22,0.066
PA,Northumberland County,34768,1857310,1729,72032,1751,69050,22,0.063
IN,Perry County,6827,381203,325,13220,329,11924,4,0.059
KY,Green County,3486,150435,204,5963,206,6711,2,0.057
KY,Fulton County,1758,75968,165,4619,166,4640,1,0.057
IA,Mills County,5326,398026,361,18823,364,19693,3,0.056
KS,Republic County,1915,92125,74,2158,75,3037,1,0.052
NC,Swain County,6256,289141,392,13879,395,19431,3,0.048
MI,Ionia County,21561,1233253,1545,64674,1555,64852,10,0.046
KY,Estill County,4334,189700,204,6665,206,8018,2,0.046
ID,Caribou County,2233,131678,143,5990,144,7935,1,0.045
WV,Webster County,2434,137105,100,3092,101,3415,1,0.041
SC,Greenwood County,22716,1255828,1333,58310,1342,65457,9,0.04
MI,Shiawassee County,26326,1439584,1647,70599,1657,71216,10,0.038
FL,Escambia County,109261,6607617,10171,516907,10211,563282,40,0.037
TN,McNairy County,8129,384993,550,19745,553,21154,3,0.037
VT,Washington County,25040,1733490,1609,81954,1618,91771,9,0.036
WI,Brown County,104574,8205186,5412,368842,5450,291728,38,0.036
GA,Upson County,8303,397721,486,16456,489,16870,3,0.036
MI,Tuscola County,20136,1020327,1129,46043,1136,41746,7,0.035
KY,Woodford County,9616,770577,768,40730,771,40279,3,0.031
AL,Jackson County,16698,868072,890,38548,895,43330,5,0.03
MO,McDonald County,6761,303931,630,20356,632,21201,2,0.03
SC,Clarendon County,10323,464190,700,25457,703,31234,3,0.029
OR,Umatilla County,24773,1401640,1520,65197,1527,63221,7,0.028
NC,Gates County,3629,197139,223,8388,224,8529,1,0.028
NC,Richmond County,14170,620608,702,25498,706,23275,4,0.028
MS,Grenada County,7288,360906,447,17175,449,16487,2,0.027
TX,Anderson County,15135,794004,1147,49593,1151,54046,4,0.026
IN,Spencer County,7575,545439,458,20315,460,20802,2,0.026
VT,Caledonia County,12024,650589,653,31019,656,30414,3,0.025
OK,Pittsburg County,13658,724920,858,36850,861,38629,3,0.022
CA,Kern County,267816,16042897,11960,677103,12019,546539,59,0.022
OR,Hood River County,9166,684461,743,39852,745,55418,2,0.022
FL,Jackson County,14204,688561,1015,35563,1018,38688,3,0.021
NY,Ontario County,43465,3391169,2889,171878,2898,182461,9,0.021
CT,Middlesex County,66080,6490994,4773,391128,4785,335377,12,0.018
OK,Cherokee County,13242,663079,1045,42074,1047,42011,2,0.015
PA,Somerset County,28544,1536874,991,43335,995,45073,4,0.014
PA,Schuylkill County,54816,3176511,2193,109625,2200,100573,7,0.013
PA,Berks County,164052,11494526,7126,542622,7144,360072,18,0.011
PA,Bucks County,259480,28567570,13881,1154922,13909,1177325,28,0.011
TN,Hamblen County,20636,1107302,1496,58248,1498,60982,2,0.01
OH,Lawrence County,20356,1066043,972,39055,974,36960,2,0.01
VA,Wythe County,10025,507776,537,21335,538,21612,1,0.01
WI,Clark County,12109,700796,676,28492,677,26716,1,0.008
IN,Knox County,12937,762394,706,26744,707,26209,1,0.008
MI,Livingston County,73672,6998950,5346,360623,5349,371495,3,0.004
MI,Midland County,31566,3143163,2195,201406,2196,141193,1,0.003
ND,Slope County,266,19030,-1,-1,-1,-1,0,0.0
VA,King and Queen County,2484,136646,218,8620,218,8403,0,0.0
UT,Piute County,401,15889,23,1019,23,843,0,0.0
NE,Thurston County,2114,99307,112,3280,112,3589,0,0.0
NE,Sioux County,401,15764,-1,-1,-1,-1,0,0.0
CA,Trinity County,3487,183469,249,12485,249,10982,0,0.0
ID,Cassia County,7200,395147,619,23909,619,30182,0,0.0
TX,Young County,5956,409802,374,20160,374,19229,0,0.0
NM,Harding County,244,9468,-1,-1,-1,-1,0,0.0
NE,McPherson County,166,7622,-1,-1,-1,-1,0,0.0
CO,Hinsdale County,291,20953,-1,-1,-1,-1,0,0.0
ID,Clark County,239,10038,-1,-1,-1,-1,0,0.0
NE,Grant County,255,14127,-1,-1,-1,-1,0,0.0
KS,Russell County,2549,120326,144,5440,144,4981,0,0.0
ND,Golden Valley County,641,42119,-1,-1,-1,-1,0,0.0
VA,Highland County,894,40428,26,1154,26,1427,0,0.0
KS,Wallace County,565,29576,-1,-1,-1,-1,0,0.0
MT,Wibaux County,355,18800,-1,-1,-1,-1,0,0.0
NV,Mineral County,1488,71723,116,5637,116,3806,0,0.0
ND,Nelson County,1213,79363,52,1676,52,1861,0,0.0
NE,Dundy County,647,28832,-1,-1,-1,-1,0,0.0
NE,Arthur County,149,4384,-1,-1,-1,-1,0,0.0
NE,Banner County,235,9936,-1,-1,-1,-1,0,0.0
NE,Blaine County,172,5573,-1,-1,-1,-1,0,0.0
ND,Sheridan County,500,23369,22,1027,22,950,0,0.0
MT,Petroleum County,153,5881,-1,-1,-1,-1,0,0.0
NE,Keya Paha County,301,13201,-1,-1,-1,-1,0,0.0
NE,Pawnee County,996,48209,41,1706,41,1055,0,0.0
IA,Humboldt County,3598,247059,196,9110,196,9487,0,0.0
MI,Osceola County,7877,372801,657,25447,657,25326,0,0.0
MT,Carter County,482,24460,-1,-1,-1,-1,0,0.0
AR,Calhoun County,1490,83730,85,2903,85,3226,0,0.0
TX,Loving County,28,2788,-1,-1,-1,-1,0,0.0
TX,Gregg County,41650,2575835,3705,185950,3705,173707,0,0.0
IA,Ida County,2670,191511,151,6615,151,6344,0,0.0
TX,Hall County,896,39402,62,2602,62,1988,0,0.0
TX,King County,89,4088,-1,-1,-1,-1,0,0.0
SD,Stanley County,1195,87700,107,6066,107,6446,0,0.0
TX,Kenedy County,111,5121,-1,-1,-1,-1,0,0.0
IA,Lyon County,4218,285299,161,6966,161,7124,0,0.0
NY,Warren County,26650,1872000,1999,102448,1999,103801,0,0.0
MO,Greene County,100170,6532717,7757,357441,7756,370778,-1,-0.001
MT,Lake County,9848,515493,787,32389,786,44115,-1,-0.01
OH,Clark County,50092,2729496,2610,113297,2605,107490,-5,-0.01
CA,Stanislaus County,178333,11230243,9340,495180,9320,458844,-20,-0.011
KS,Pottawatomie County,8315,592820,744,40487,743,42266,-1,-0.012
CA,Lassen County,7602,480529,651,35182,650,29569,-1,-0.013
MS,Itawamba County,7251,374426,547,19028,546,18504,-1,-0.014
NM,Rio Arriba County,13065,608059,666,30024,664,27833,-2,-0.015
OH,Butler County,135030,9868136,9612,534745,9589,490133,-23,-0.017
IA,Hamilton County,5652,386420,335,16450,334,15265,-1,-0.018
SC,Sumter County,35798,1746685,2918,127137,2911,121537,-7,-0.02
CA,San Luis Obispo County,103543,8673110,6568,422982,6547,503181,-21,-0.02
IA,Linn County,85638,6763789,4768,346197,4750,245263,-18,-0.021
MO,Dent County,4687,207264,297,10119,296,11092,-1,-0.021
OH,Ross County,25923,1420423,1332,56640,1326,54199,-6,-0.023
UT,Davis County,108177,9425533,10296,617917,10270,594401,-26,-0.024
IN,Jasper County,11908,737397,800,37004,797,36462,-3,-0.025
IA,Cedar County,7063,387343,494,26138,492,23944,-2,-0.028
IN,Wells County,10567,654915,671,29122,668,27617,-3,-0.028
IN,Rush County,6267,354577,441,17157,439,18032,-2,-0.032
KY,McCracken County,23646,1632599,1577,80039,1569,73032,-8,-0.034
WV,Brooke County,8623,492575,492,20922,489,20448,-3,-0.035
MO,Randolph County,8119,429373,545,20648,542,20684,-3,-0.037
IA,Harrison County,5318,332295,302,13389,300,15248,-2,-0.038
MS,Prentiss County,7460,348772,429,14367,426,12632,-3,-0.04
OH,Meigs County,7476,371028,342,11632,339,15000,-3,-0.04
TX,San Augustine County,2507,112322,175,6160,174,10122,-1,-0.04
GA,Coffee County,11819,539041,610,21439,605,19309,-5,-0.042
MS,Panola County,11303,504460,634,23340,629,24267,-5,-0.044
OH,Van Wert County,11163,625094,623,24920,618,24492,-5,-0.045
ND,Ramsey County,4493,293826,268,11580,266,10605,-2,-0.045
DE,New Castle County,209473,17550167,11183,817252,11086,734691,-97,-0.046
AR,Pope County,19506,1166297,1351,54437,1342,60182,-9,-0.046
SD,Day County,2117,113406,102,3690,101,5022,-1,-0.047
OK,Oklahoma County,257177,19814304,19687,1105979,19565,1082976,-122,-0.047
NJ,Burlington County,175353,16304726,11794,835003,11709,751995,-85,-0.048
OH,Highland County,14459,687050,968,36062,961,37134,-7,-0.048
TN,Gibson County,16460,842545,1160,46107,1152,47180,-8,-0.049
NE,Box Butte County,4081,247820,255,13920,253,11076,-2,-0.049
AL,Lee County,47070,3292931,4706,221088,4683,269264,-23,-0.049
MD,Carroll County,65930,6174528,4200,299699,4166,290397,-34,-0.052
TX,Duval County,3421,144881,204,7911,202,7429,-2,-0.058
PA,Bedford County,18796,1002337,688,27188,677,36920,-11,-0.059
AL,Houston County,34076,2174907,2672,115264,2652,118412,-20,-0.059
KY,Monroe County,3416,148004,152,4630,150,3899,-2,-0.059
IL,White County,5016,296719,257,10660,254,10058,-3,-0.06
GA,Peach County,8318,478257,943,35592,938,41893,-5,-0.06
CA,Mono County,4846,363248,526,26081,523,36746,-3,-0.062
NM,Grant County,9581,463163,621,27811,615,30611,-6,-0.063
AR,Yell County,6347,285982,460,16141,456,17156,-4,-0.063
MS,Lincoln County,10831,606948,565,22478,558,24582,-7,-0.065
MT,Roosevelt County,3065,150013,171,8026,169,8967,-2,-0.065
AL,Chambers County,10758,550450,792,33311,785,27038,-7,-0.065
NM,Dona Ana County,71909,3583296,4667,200932,4619,209097,-48,-0.067
PA,Westmoreland County,147298,10465467,6146,337388,6048,333459,-98,-0.067
OK,Sequoyah County,11931,568313,828,32370,820,31222,-8,-0.067
TX,Crane County,1491,99844,100,9058,99,4537,-1,-0.067
KS,Stafford County,1501,72788,75,3617,74,3196,-1,-0.067
NV,Humboldt County,5853,416941,485,29518,481,23434,-4,-0.068
OH,Paulding County,7269,369667,397,15491,392,15784,-5,-0.069
AZ,Apache County,18813,796008,1750,60646,1737,62721,-13,-0.069
NY,Delaware County,16024,856085,1050,50177,1039,54196,-11,-0.069
MS,Jones County,20777,1114408,1125,40828,1110,42570,-15,-0.072
OH,Mercer County,16760,1081512,689,29509,677,33484,-12,-0.072
IA,Benton County,9616,682239,611,29462,604,28781,-7,-0.073
VA,Greensville County,2712,126340,273,8998,271,8479,-2,-0.074
NC,Columbus County,16214,732947,778,26442,766,26425,-12,-0.074
VA,Halifax County,12051,597809,503,21435,494,20932,-9,-0.075
MS,Alcorn County,10661,578319,613,25658,605,22803,-8,-0.075
NE,Holt County,3971,194583,181,7954,178,7584,-3,-0.076
OK,Osage County,13184,783189,1372,84663,1362,66108,-10,-0.076
GA,Washington County,6321,333601,247,12510,242,8477,-5,-0.079
GA,Mitchell County,6281,274149,417,12828,412,11912,-5,-0.08
WI,Winnebago County,66286,4741916,4804,267483,4751,238026,-53,-0.08
WI,Taylor County,7522,374263,414,18927,408,17795,-6,-0.08
MI,Eaton County,41659,2691758,3848,187005,3814,168361,-34,-0.082
GA,Glynn County,27954,1951400,2248,113217,2225,163108,-23,-0.082
TN,Decatur County,3631,170398,221,8031,218,9768,-3,-0.083
WI,Manitowoc County,32493,2044450,1456,68368,1429,74912,-27,-0.083
VA,Franklin County,19320,1165143,1163,67251,1147,88055,-16,-0.083
PA,Luzerne County,127435,7470104,5210,252922,5104,217332,-106,-0.083
IL,Wayne County,5979,309876,266,10740,261,10381,-5,-0.084
OH,Geauga County,36651,4022005,2272,165597,2241,187461,-31,-0.085
MI,Macomb County,351265,22895048,18123,1076090,17820,841068,-303,-0.086
IN,Decatur County,10089,583860,695,29994,686,30476,-9,-0.089
SD,Todd County,2236,82736,116,3301,114,3434,-2,-0.089
VA,Amherst County,11172,602412,777,32424,767,36169,-10,-0.09
KY,Henry County,5451,301940,465,18545,460,20309,-5,-0.092
CO,Logan County,6534,404700,478,49202,472,18814,-6,-0.092
IL,Edgar County,6530,364993,290,11136,284,10504,-6,-0.092
KY,Boyd County,14993,890966,1018,44224,1004,42577,-14,-0.093
WY,Johnson County,3228,212330,266,12856,263,16255,-3,-0.093
IL,Clinton County,13930,1032834,790,35463,777,36257,-13,-0.093
WI,Pierce County,14877,1128067,1276,70774,1262,72403,-14,-0.094
IL,Stark County,2111,125789,109,4329,107,4278,-2,-0.095
PA,Delaware County,215856,21633866,13143,1022389,12936,1031557,-207,-0.096
OH,Auglaize County,18473,1223460,1049,49525,1031,53235,-18,-0.097
GA,Laurens County,15514,813517,839,32997,824,32960,-15,-0.097
CA,Kings County,41871,2281083,3241,158136,3200,136878,-41,-0.098
MO,Jasper County,38881,2143279,2995,127152,2957,118995,-38,-0.098
IL,Whiteside County,22472,1308511,1004,45531,982,40787,-22,-0.098
TX,Kinney County,1012,54273,61,3050,60,2965,-1,-0.099
MS,Pontotoc County,10010,502859,693,25807,683,23074,-10,-0.1
MN,Fillmore County,7977,470097,487,21767,479,21690,-8,-0.1
MN,Sibley County,5893,353593,380,16347,374,17242,-6,-0.102
GA,Gwinnett County,299933,21122144,29711,1702570,29403,1547978,-308,-0.103
SC,Richland County,133628,9236084,13121,708782,12983,617870,-138,-0.103
WY,Laramie County,37457,2658257,3187,168850,3148,169359,-39,-0.104
IA,Jefferson County,5795,351551,436,18167,430,9155,-6,-0.104
NJ,Salem County,23738,1654117,1453,76133,1428,74434,-25,-0.105
MI,Kent County,241824,18943617,14235,813407,13979,793296,-256,-0.106
IN,Pike County,4512,251698,264,9462,259,12490,-5,-0.111
NC,Cumberland County,102086,5273214,13926,621721,13809,544401,-117,-0.115
OK,Adair County,5960,241880,395,12941,388,13006,-7,-0.117
IN,Clinton County,11990,639826,754,32476,740,27459,-14,-0.117
WI,Green County,15288,1037967,911,49351,893,48226,-18,-0.118
VA,Campbell County,19471,1165334,1721,67907,1698,69489,-23,-0.118
OH,Hancock County,29414,2066780,1858,98847,1823,96826,-35,-0.119
PA,Huntingdon County,15773,899796,656,28380,637,31815,-19,-0.12
MI,Berrien County,57297,3688038,3341,192080,3272,208735,-69,-0.12
WY,Platte County,3304,202745,227,10096,223,10986,-4,-0.121
CA,Mendocino County,30616,1834542,1819,104702,1782,112445,-37,-0.121
NC,Sampson County,19828,957551,1111,36322,1087,36462,-24,-0.121
ME,Penobscot County,54471,3239598,3068,148356,3002,139529,-66,-0.121
OH,Williams County,14752,789984,743,31475,725,28052,-18,-0.122
PA,Columbia County,23733,1430721,1346,65718,1317,63788,-29,-0.122
NE,Nuckolls County,1636,82817,63,3118,61,2879,-2,-0.122
WA,King County,870653,118721944,64891,5749471,63819,5370689,-1072,-0.123
NC,Craven County,34604,2057062,3945,173227,3902,191891,-43,-0.124
TX,Bowie County,31066,1830960,2283,113931,2244,96226,-39,-0.126
KS,Nemaha County,3955,278977,164,8321,159,6446,-5,-0.126
NC,Orange County,45422,5221841,5952,410097,5894,433279,-58,-0.128
NC,Martin County,7834,349547,396,12163,386,12209,-10,-0.128
NE,Colfax County,3889,213900,289,12152,284,10522,-5,-0.129
MI,Genesee County,150229,8714753,7609,365105,7415,337560,-194,-0.129
NY,Schuyler County,6968,391515,480,19547,471,24885,-9,-0.129
MO,Clark County,2289,110785,155,5870,152,6745,-3,-0.131
VA,Pittsylvania County,21590,1141054,1273,50865,1244,48106,-29,-0.134
IL,Ogle County,20000,1357017,1296,63323,1269,62221,-27,-0.135
IN,Elkhart County,73857,5229975,4043,220939,3940,191600,-103,-0.139
NV,Elko County,17906,1405998,1383,84200,1358,78629,-25,-0.14
AL,Lamar County,4270,203997,209,7735,203,7785,-6,-0.141
OH,Huron County,22722,1256538,1468,59745,1436,55664,-32,-0.141
ND,Ransom County,2102,136821,101,4319,98,4848,-3,-0.143
MS,Yalobusha County,4188,180779,288,10826,282,11875,-6,-0.143
PA,Mifflin County,17701,888451,637,27610,611,23410,-26,-0.147
IN,Daviess County,11484,686658,555,21252,538,19500,-17,-0.148
IN,Madison County,46779,2493471,2799,115562,2729,108799,-70,-0.15
OH,Stark County,147383,9223349,6501,336761,6272,293737,-229,-0.155
MO,Callaway County,15366,871930,1208,46405,1184,54731,-24,-0.156
TN,Madison County,33945,2062505,2518,118240,2465,105445,-53,-0.156
IN,Bartholomew County,30783,2326750,2217,134015,2168,116938,-49,-0.159
GA,Early County,3128,132960,189,6135,184,6410,-5,-0.16
VA,Prince William County,161889,14842907,17951,1269308,17690,1096015,-261,-0.161
OR,Gilliam County,618,36670,53,3002,52,2305,-1,-0.162
MI,St. Clair County,62537,3809603,3209,144953,3108,162770,-101,-0.162
IL,Lee County,12881,806855,821,40110,800,36904,-21,-0.163
NJ,Sussex County,56508,5352440,3779,288682,3685,249112,-94,-0.166
IL,Montgomery County,10167,609491,518,23938,501,19934,-17,-0.167
AL,Coosa County,2993,143833,293,10977,288,11927,-5,-0.167
MS,Union County,8911,463627,631,25156,616,25651,-15,-0.168
IN,Greene County,11309,616672,705,28380,686,28885,-19,-0.168
MA,Norfolk County,271058,45304006,23391,2374621,22934,2317114,-457,-0.169
TN,Unicoi County,5866,285826,402,15267,392,15485,-10,-0.17
VT,Addison County,15208,1060648,1053,52187,1027,57901,-26,-0.171
NY,Fulton County,20212,1110852,1163,59949,1128,53877,-35,-0.173
MI,Alpena County,11434,582125,562,21738,542,22705,-20,-0.175
KS,Marshall County,3994,239076,162,6671,155,5384,-7,-0.175
TN,Chester County,5130,251600,439,15310,430,16287,-9,-0.175
GA,Colquitt County,13082,617443,705,28884,682,28902,-23,-0.176
NE,Douglas County,208967,18422571,14885,946017,14517,843916,-368,-0.176
IN,Putnam County,12428,730620,1008,46403,986,44886,-22,-0.177
VA,Lee County,6162,265396,265,9404,254,8201,-11,-0.179
MI,Lapeer County,33344,2159093,2238,107764,2178,115728,-60,-0.18
AL,Cleburne County,4439,233526,304,11583,296,12231,-8,-0.18
CA,Fresno County,315616,19719085,11977,632314,11407,579135,-570,-0.181
PA,Beaver County,68572,4271556,3289,170474,3165,178452,-124,-0.181
MN,Lincoln County,2170,126273,128,5213,124,5514,-4,-0.184
VA,Giles County,5960,322152,323,16296,312,12884,-11,-0.185
IN,Martin County,3741,208185,206,9665,199,8468,-7,-0.187
MN,Brown County,10644,681035,552,25481,532,21884,-20,-0.188
CO,Costilla County,1066,43636,55,1506,53,2005,-2,-0.188
AR,Polk County,5830,262458,354,13073,343,14719,-11,-0.189
IL,Williamson County,23724,1452223,1569,72525,1524,69916,-45,-0.19
MD,Dorchester County,12045,645273,782,33908,759,36978,-23,-0.191
AL,Lauderdale County,30111,1848340,1796,81278,1738,85208,-58,-0.193
IA,Grundy County,4657,383735,287,16044,278,12633,-9,-0.193
OH,Summit County,211689,15120306,11871,716366,11457,728064,-414,-0.196
OK,Garvin County,8163,459629,653,26044,637,27162,-16,-0.196
GA,Burke County,7116,352563,549,19053,535,22696,-14,-0.197
MA,Dukes County,8608,753089,537,38790,520,69455,-17,-0.197
WI,Racine County,76288,5358867,4524,252876,4373,234295,-151,-0.198
TX,Calhoun County,6996,411881,528,25324,514,24736,-14,-0.2
WV,Pocahontas County,3001,131778,123,4713,117,4613,-6,-0.2
NJ,Hunterdon County,49911,7333334,3435,475423,3335,315983,-100,-0.2
GA,Bulloch County,19447,1107586,2039,81488,2000,80251,-39,-0.201
GA,Randolph County,1984,79270,123,3698,119,3363,-4,-0.202
VA,Russell County,7891,389487,388,15289,372,15662,-16,-0.203
AR,Sebastian County,40720,2534622,3127,153990,3044,121708,-83,-0.204
WV,Raleigh County,24061,1295876,1138,52496,1089,44734,-49,-0.204
NE,Thayer County,1955,118949,87,3323,83,3114,-4,-0.205
IA,Appanoose County,4383,210402,206,7834,197,8491,-9,-0.205
OH,Montgomery County,201179,12748989,12244,700699,11830,571301,-414,-0.206
MD,Garrett County,11057,636729,514,25112,491,31358,-23,-0.208
MI,Huron County,13431,719600,573,23864,545,27213,-28,-0.208
NY,Otsego County,21378,1282330,1423,70069,1378,70802,-45,-0.21
SC,Darlington County,21792,1095837,1398,56764,1352,56949,-46,-0.211
WI,Portage County,27166,1840699,1694,75882,1636,76016,-58,-0.214
MO,Reynolds County,1871,78360,106,2680,102,3571,-4,-0.214
SD,Moody County,2326,140457,142,9896,137,5638,-5,-0.215
KY,Graves County,12051,618163,669,23982,643,24136,-26,-0.216
MI,Van Buren County,26871,1557602,2036,88433,1978,101967,-58,-0.216
KY,Warren County,41112,2672742,3126,141246,3037,128752,-89,-0.216
GA,Thomas County,14327,881292,1038,45924,1007,46950,-31,-0.216
IA,Cherokee County,4637,282345,221,10982,211,8265,-10,-0.216
AL,Winston County,6953,366000,486,21091,471,24820,-15,-0.216
KY,Lincoln County,7385,339711,563,18452,547,22819,-16,-0.217
IL,Brown County,1843,108542,95,3696,91,3653,-4,-0.217
OH,Washington County,23287,1341998,1100,51844,1049,50342,-51,-0.219
WI,Eau Claire County,37976,3090373,2922,145424,2839,145705,-83,-0.219
OH,Trumbull County,79856,4164003,3620,155858,3444,132010,-176,-0.22
PA,Clearfield County,29885,1591541,1255,54793,1189,51201,-66,-0.221
MO,Pike County,5845,300165,337,14248,324,15364,-13,-0.222
KY,Greenup County,11678,717166,782,37023,756,31765,-26,-0.223
MI,Oakland County,493700,55555032,32252,2314449,31153,2125730,-1099,-0.223
CA,Tulare County,142546,7530334,5713,284343,5394,239344,-319,-0.224
NY,Columbia County,24120,1848313,1505,93368,1451,116061,-54,-0.224
GA,Murray County,11572,556510,843,33037,817,27130,-26,-0.225
VT,Bennington County,15012,1084785,874,54419,840,56423,-34,-0.226
IN,Kosciusko County,30138,2079272,1992,133031,1924,103017,-68,-0.226
NE,Keith County,3082,170055,200,8226,193,10193,-7,-0.227
GA,Schley County,1315,65816,97,2864,94,3356,-3,-0.228
MI,Mecosta County,13079,746508,1258,48167,1228,53853,-30,-0.229
IA,Audubon County,2175,133139,97,4970,92,3426,-5,-0.23
OH,Clinton County,15149,940594,1111,48113,1076,43762,-35,-0.231
NH,Grafton County,34672,3202363,3249,213787,3169,223098,-80,-0.231
WI,Crawford County,6352,333367,380,15557,365,16055,-15,-0.236
MA,Berkshire County,52653,3702620,2156,144858,2032,142403,-124,-0.236
NY,Rensselaer County,62123,4349869,4860,256521,4713,224097,-147,-0.237
IL,Kane County,188700,16798538,14199,965543,13752,863889,-447,-0.237
TX,Taylor County,45988,2958182,4113,186441,4004,192331,-109,-0.237
MN,Wilkin County,2526,158424,166,7999,160,6477,-6,-0.238
OH,Fulton County,16817,1028728,1001,45041,961,43741,-40,-0.238
PA,Jefferson County,17061,927044,816,30871,775,28621,-41,-0.24
TN,Dyer County,12456,710520,743,30800,713,29728,-30,-0.241
MO,Sullivan County,2077,84336,160,5321,155,5203,-5,-0.241
GA,Telfair County,2891,118490,216,6924,209,6138,-7,-0.242
GA,Wilcox County,2052,83202,116,4130,111,3603,-5,-0.244
AL,Escambia County,11071,539007,661,25911,634,24381,-27,-0.244
OH,Morgan County,4843,230788,265,9624,253,9562,-12,-0.248
OH,Fayette County,10467,530156,673,26958,647,24537,-26,-0.248
MN,Beltrami County,15232,902390,1079,48944,1041,51051,-38,-0.249
KS,Rice County,3180,176482,223,8865,215,9079,-8,-0.252
VA,Nottoway County,4757,235681,281,10062,269,10628,-12,-0.252
MN,Clay County,21820,1445028,2051,97610,1996,86873,-55,-0.252
OH,Preble County,15445,838188,861,35991,822,34481,-39,-0.253
IL,Woodford County,14144,1251241,946,62862,910,53631,-36,-0.255
MI,Baraga County,2738,136207,123,4579,116,5333,-7,-0.256
TX,Fisher County,1165,71080,93,3846,90,4433,-3,-0.258
MA,Worcester County,319756,27046242,15631,1159915,14806,949727,-825,-0.258
MI,Dickinson County,10459,627961,513,23966,486,20481,-27,-0.258
NJ,Camden County,190601,14773259,12351,785838,11857,686409,-494,-0.259
KY,Muhlenberg County,9647,496144,439,17048,414,13924,-25,-0.259
MN,Watonwan County,4169,232677,210,8843,199,7980,-11,-0.264
CA,San Diego County,1248474,110803163,71198,4891830,67893,4650336,-3305,-0.265
KS,Ness County,1134,60984,49,1859,46,1876,-3,-0.265
NY,Schenectady County,60995,4272889,4474,278693,4311,231817,-163,-0.267
CT,Litchfield County,74812,6568851,4602,358868,4402,314180,-200,-0.267
CT,Windham County,44083,2892033,2772,146251,2654,131072,-118,-0.268
WI,Marathon County,55002,3877993,2730,140501,2582,132370,-148,-0.269
GA,Grady County,7431,341925,464,16163,444,15816,-20,-0.269
MI,St. Joseph County,22114,1220647,1323,57071,1263,58184,-60,-0.271
PA,Lehigh County,143785,10688940,9434,513137,9041,484917,-393,-0.273
NJ,Gloucester County,109819,9287288,7063,439797,6763,386625,-300,-0.273
NC,Watauga County,14529,978383,1620,71473,1580,94921,-40,-0.275
OH,Erie County,30844,1899165,1950,92727,1865,86167,-85,-0.276
OH,Tuscarawas County,35717,2116732,1628,70692,1529,67181,-99,-0.277
MI,Bay County,42673,2405444,2153,94916,2035,87201,-118,-0.277
WV,Jackson County,9745,537189,462,19148,435,17988,-27,-0.277
KS,Allen County,4669,235394,289,10499,276,8526,-13,-0.278
PA,Lawrence County,33423,1919279,1453,63397,1360,62218,-93,-0.278
MS,Marshall County,11508,495605,921,35213,889,35102,-32,-0.278
NM,Bernalillo County,243953,15772033,14984,818514,14305,767058,-679,-0.278
WY,Teton County,10727,3408826,1218,109912,1188,212532,-30,-0.28
OK,Harmon County,711,30354,24,978,22,579,-2,-0.281
WY,Weston County,2488,158856,162,8110,155,8083,-7,-0.281
UT,Utah County,167623,14274594,13299,754493,12824,771617,-475,-0.283
AL,DeKalb County,21078,1018194,1199,47723,1139,42618,-60,-0.285
MN,Olmsted County,61721,5565025,4194,269751,4018,224854,-176,-0.285
MO,Moniteau County,5242,278664,316,11603,301,11942,-15,-0.286
OH,Defiance County,15264,882054,902,35603,858,33641,-44,-0.288
IA,Boone County,10027,707752,750,35743,721,35429,-29,-0.289
SD,Lawrence County,9686,760456,936,42176,908,51908,-28,-0.289
MO,Scott County,13081,763862,1030,39404,992,34291,-38,-0.29
CA,Contra Costa County,428412,55050836,29489,2934471,28243,2777893,-1246,-0.291
MS,Webster County,3075,151737,218,8187,209,9209,-9,-0.293
WI,Ashland County,5793,292262,389,17946,372,19222,-17,-0.293
NV,White Pine County,3036,188115,247,13361,238,10233,-9,-0.296
SC,Hampton County,6075,276645,343,13364,325,10378,-18,-0.296
MO,Jackson County,251867,16477818,20018,1093341,19270,975569,-748,-0.297
PA,Blair County,48516,2870148,1646,70138,1502,69503,-144,-0.297
ID,Jerome County,7055,325212,666,22863,645,27089,-21,-0.298
MN,Redwood County,5981,366213,343,15791,325,14339,-18,-0.301
TX,Freestone County,5964,329604,438,20430,420,21453,-18,-0.302
OH,Muskingum County,31923,1708286,1536,72012,1439,62369,-97,-0.304
NY,Dutchess County,112776,9909451,6886,446557,6541,459102,-345,-0.306
ND,Foster County,1305,101952,56,2295,52,2346,-4,-0.307
GA,Emanuel County,6781,316109,412,12998,391,12321,-21,-0.31
ND,Richland County,6136,432412,445,19746,426,18689,-19,-0.31
MN,Rice County,23165,1721867,1715,91807,1643,88723,-72,-0.311
NC,Jones County,3213,145287,297,11463,287,10408,-10,-0.311
NY,Niagara County,84316,5127095,3789,179228,3526,168956,-263,-0.312
IN,Vanderburgh County,67059,4258970,4226,217009,4017,184555,-209,-0.312
IA,Jackson County,7689,433940,411,15215,387,16102,-24,-0.312
NE,Nance County,1276,55869,70,2844,66,2617,-4,-0.313
WV,Ohio County,15904,1192647,1024,50918,974,48426,-50,-0.314
MO,Cape Girardeau County,27394,1887257,1896,84348,1810,79672,-86,-0.314
TX,Carson County,1891,127186,174,9657,168,9136,-6,-0.317
NE,Lancaster County,114830,8599512,6404,342516,6038,315537,-366,-0.319
IA,Taylor County,2186,104068,136,5725,129,5798,-7,-0.32
KS,Greenwood County,2190,105504,98,3703,91,4111,-7,-0.32
CO,Gunnison County,5918,403159,711,39750,692,49513,-19,-0.321
MN,Mower County,14912,982602,901,48977,853,38164,-48,-0.322
AR,Dallas County,2167,101876,148,5252,141,4990,-7,-0.323
NY,Herkimer County,22753,1285154,1245,54306,1171,52984,-74,-0.325
OH,Hardin County,10455,524036,609,25109,575,21513,-34,-0.325
WV,Wirt County,1847,86543,87,3367,81,2936,-6,-0.325
MI,Hillsdale County,15557,822104,975,41023,924,40586,-51,-0.328
CA,Marin County,104097,21886344,7162,1074580,6820,1401143,-342,-0.329
KY,Carter County,8169,407252,433,14736,406,15021,-27,-0.331
MT,Beaverhead County,3322,191534,295,11135,284,12440,-11,-0.331
SD,Lyman County,1206,57506,64,2198,60,2191,-4,-0.332
OH,Brown County,15036,786291,1144,44507,1094,42703,-50,-0.333
SD,Bennett County,902,31333,45,1397,42,1196,-3,-0.333
MN,Swift County,3604,206478,217,10115,205,7514,-12,-0.333
IN,Dubois County,17435,1358358,812,41046,754,30078,-58,-0.333
MS,Simpson County,8077,382015,509,16059,482,17693,-27,-0.334
IN,Dearborn County,19162,1326993,1284,64128,1220,61752,-64,-0.334
KS,Saline County,20672,1308064,1326,58895,1257,49849,-69,-0.334
WV,Pendleton County,2696,120750,101,3291,92,3452,-9,-0.334
MO,Madison County,3885,191955,266,9056,253,8414,-13,-0.335
NE,Pierce County,2685,163020,155,6133,146,6290,-9,-0.335
NE,Saline County,5059,293255,377,16281,360,15711,-17,-0.336
IN,Posey County,9530,709841,642,33119,610,33916,-32,-0.336
MT,Musselshell County,1490,78361,129,3655,124,6097,-5,-0.336
MN,Hennepin County,499957,55874322,39718,3011832,38035,2458349,-1683,-0.337
OH,Ashtabula County,35750,1812387,1689,69746,1568,61961,-121,-0.338
VT,Windham County,18282,1086797,1263,60346,1201,53321,-62,-0.339
MO,St. Louis County,387097,40987838,26482,1840109,25165,1582118,-1317,-0.34
OK,Kay County,14134,829002,927,44527,879,36169,-48,-0.34
NJ,Monmouth County,247565,31446320,14462,1281890,13619,1388139,-843,-0.341
WA,Yakima County,87141,5056237,3629,159098,3332,160019,-297,-0.341
SC,Marlboro County,8200,312269,422,13254,394,12390,-28,-0.341
IL,McHenry County,119484,10667251,8219,577761,7812,482534,-407,-0.341
OK,Kingfisher County,5241,510181,339,20187,321,21179,-18,-0.343
VA,Lunenburg County,3789,182453,229,7625,216,8085,-13,-0.343
IN,Newton County,5205,293817,402,15629,384,18877,-18,-0.346
NE,Lincoln County,12989,808316,788,38940,743,31054,-45,-0.346
PA,Clinton County,13831,753595,731,30061,683,27150,-48,-0.347
WY,Converse County,4890,474481,395,21235,378,18868,-17,-0.348
GA,Bacon County,3142,153666,187,5131,176,6209,-11,-0.35
IA,Scott County,64590,5373710,4132,287251,3905,217336,-227,-0.351
IN,Miami County,12135,615609,852,32508,809,29893,-43,-0.354
MO,Marion County,9882,553978,680,25907,645,27246,-35,-0.354
IL,Jefferson County,13248,755908,739,35461,692,30492,-47,-0.355
AR,Newton County,2252,89285,183,6952,175,6383,-8,-0.355
NY,Schoharie County,11265,659248,704,33958,664,32909,-40,-0.355
IA,Washington County,8429,530665,516,23034,486,25258,-30,-0.356
OH,Belmont County,24814,1623036,1112,54718,1023,48286,-89,-0.359
CO,Boulder County,118784,14295641,13312,947711,12885,1083493,-427,-0.359
AL,Tuscaloosa County,63351,4196259,3914,184222,3686,187622,-228,-0.36
PA,Fayette County,49754,2691374,1913,83413,1733,73368,-180,-0.362
PA,Dauphin County,110984,7566955,7664,390181,7261,344235,-403,-0.363
MA,Essex County,313172,31622947,17101,1307782,15962,1260065,-1139,-0.364
WV,Marion County,20529,1186644,1167,58386,1092,49581,-75,-0.365
TX,Garza County,1368,83002,81,3931,76,3568,-5,-0.365
NE,Gage County,8212,480936,474,20509,444,19250,-30,-0.365
TX,Hidalgo County,252737,10776962,7755,333842,6832,291551,-923,-0.365
MI,Kalamazoo County,94310,7136787,6332,365181,5988,313230,-344,-0.365
IL,Henry County,19197,1265884,1115,54253,1045,49694,-70,-0.365
NE,Seward County,6026,461173,405,17881,383,18614,-22,-0.365
KY,Pike County,15623,860462,763,34769,706,30422,-57,-0.365
OH,Darke County,20201,1087782,951,38462,877,35375,-74,-0.366
OH,Scioto County,23445,1244761,963,38389,877,32768,-86,-0.367
UT,Emery County,2995,170547,170,8303,159,6497,-11,-0.367
IA,Kossuth County,5981,378468,355,16874,333,14500,-22,-0.368
NY,Putnam County,38568,4145237,2927,237677,2785,226978,-142,-0.368
TX,Bee County,8140,399229,623,25602,593,21793,-30,-0.369
ME,Aroostook County,24387,1229880,951,47595,861,42588,-90,-0.369
FL,Taylor County,6225,317241,319,15276,296,11325,-23,-0.369
IL,Mercer County,6202,393710,386,18426,363,17429,-23,-0.371
CO,San Juan County,269,12130,24,909,23,831,-1,-0.372
WV,Grant County,4288,206460,193,6223,177,6572,-16,-0.373
IA,Louisa County,4011,235353,262,9580,247,10606,-15,-0.374
PA,Allegheny County,504386,42891999,23128,1735463,21240,1471831,-1888,-0.374
AR,Cleveland County,2400,138763,172,6624,163,6393,-9,-0.375
SC,Florence County,45808,2646721,2851,139379,2679,121474,-172,-0.375
IN,Jackson County,16758,963935,1036,43395,973,38169,-63,-0.376
GA,Whitfield County,32585,1918028,1838,85761,1715,67691,-123,-0.377
MN,Renville County,5819,352628,356,14792,334,13257,-22,-0.378
IL,Carroll County,6055,353887,325,13669,302,15504,-23,-0.38
PA,McKean County,15412,842208,606,30355,547,25103,-59,-0.383
FL,Broward County,720672,52494991,51238,3154298,48477,3387475,-2761,-0.383
KS,Norton County,1830,87899,112,5652,105,4157,-7,-0.383
IA,Allamakee County,5441,279816,260,10711,239,10537,-21,-0.386
PA,Elk County,13432,775823,385,17300,333,14048,-52,-0.387
OH,Seneca County,21176,1121024,1210,48681,1128,42886,-82,-0.387
MO,Macon County,5642,268062,336,13539,314,10897,-22,-0.39
VA,Buchanan County,5871,285092,265,10164,242,7575,-23,-0.392
MO,Linn County,4330,216158,238,8319,221,7352,-17,-0.393
IA,Pottawattamie County,33624,2192393,2130,101089,1997,92374,-133,-0.396
MO,Crawford County,7826,442330,608,18601,577,20119,-31,-0.396
MD,Baltimore County,315424,28755994,24263,1548545,23007,1269972,-1256,-0.398
NY,Genesee County,22732,1304346,1275,55213,1184,51783,-91,-0.4
WY,Campbell County,16494,1367376,1159,69482,1093,52899,-66,-0.4
OH,Champaign County,14705,824621,1033,42167,974,42227,-59,-0.401
OH,Wyandot County,8956,510828,487,19106,451,19322,-36,-0.402
KY,Adair County,5455,223414,372,10774,350,11552,-22,-0.403
MO,Saline County,7690,378693,449,16809,418,12456,-31,-0.403
NE,Otoe County,5923,423319,428,21280,404,21387,-24,-0.405
VA,Essex County,4187,247334,302,14582,285,13630,-17,-0.406
MI,Gogebic County,5391,256169,337,13192,315,12925,-22,-0.408
IA,Poweshiek County,6600,429784,515,27863,488,26823,-27,-0.409
OH,Carroll County,10009,559959,688,29119,647,29236,-41,-0.41
TX,Jack County,2434,141567,223,9196,213,11788,-10,-0.411
FL,Orange County,476445,32185088,48683,2445554,46718,2682267,-1965,-0.412
AZ,Santa Cruz County,16224,805158,968,37680,901,48370,-67,-0.413
IA,Shelby County,4586,311209,273,12339,254,10491,-19,-0.414
GA,Lanier County,2414,102890,339,10567,329,10395,-10,-0.414
MD,Allegany County,23357,1279241,1054,55071,957,42109,-97,-0.415
SC,Lee County,5306,203752,347,10620,325,8375,-22,-0.415
MN,Marshall County,3610,221492,185,8990,170,7372,-15,-0.416
IN,St. Joseph County,98529,6544958,6161,352847,5751,294566,-410,-0.416
MN,Nicollet County,12251,918488,1238,68672,1187,54618,-51,-0.416
PA,Lancaster County,215806,15622624,9266,500024,8364,460484,-902,-0.418
TX,DeWitt County,6205,540090,506,33287,480,23532,-26,-0.419
TX,Pecos County,4529,301284,375,19523,356,18286,-19,-0.42
NY,Oswego County,42650,2504298,2332,109022,2153,95828,-179,-0.42
NE,Antelope County,2378,126571,120,4689,110,4501,-10,-0.421
ND,Cass County,68076,5955097,5833,303838,5546,277537,-287,-0.422
IN,Wayne County,24099,1224508,1243,56284,1141,45947,-102,-0.423
PA,Armstrong County,26172,1456014,1240,52704,1129,49051,-111,-0.424
IN,Cass County,14105,726561,822,33806,762,27957,-60,-0.425
AL,Clarke County,7771,417525,372,15156,339,13919,-33,-0.425
IN,Wabash County,11942,708532,674,32333,623,25274,-51,-0.427
KS,Harvey County,12167,746190,903,43703,851,40000,-52,-0.427
NJ,Cape May County,38666,2799637,2535,170186,2369,214104,-166,-0.429
GA,Bibb County,49372,2831539,3860,179479,3648,153377,-212,-0.429
PA,Juniata County,9310,509290,385,16000,345,13308,-40,-0.43
KS,Cherokee County,6497,342825,504,17424,476,15926,-28,-0.431
GA,Muscogee County,62942,4018678,6656,374312,6384,281271,-272,-0.432
OK,Roger Mills County,1151,70732,63,3376,58,2514,-5,-0.434
NC,Pitt County,54100,3425159,4470,203954,4235,192331,-235,-0.434
ID,Fremont County,4127,191700,409,18075,391,20034,-18,-0.436
NY,Erie County,364968,26028580,12130,734638,10537,601288,-1593,-0.436
TX,Lee County,5946,402284,475,22031,449,24267,-26,-0.437
IL,Will County,254130,22579388,18261,1310194,17147,1096664,-1114,-0.438
KY,Jefferson County,292057,21627859,18166,1192357,16883,919639,-1283,-0.439
OH,Ashland County,19825,1095726,1206,56238,1119,49520,-87,-0.439
MN,St. Louis County,75161,5085796,4119,209018,3788,183174,-331,-0.44
WV,Greenbrier County,12039,619196,654,28573,601,27931,-53,-0.44
MO,Gentry County,2270,102688,126,3835,116,3866,-10,-0.441
IA,Dubuque County,37647,2877694,1807,150923,1641,83123,-166,-0.441
GA,Treutlen County,1804,81073,113,3250,105,3642,-8,-0.443
ID,Gooding County,4739,172538,413,14911,392,16066,-21,-0.443
WI,La Crosse County,45053,3250281,2814,136773,2614,129652,-200,-0.444
MN,Koochiching County,4725,263376,209,11497,188,8271,-21,-0.444
OH,Portage County,58629,3954497,4739,234545,4478,243686,-261,-0.445
OH,Shelby County,18840,1179627,1012,50145,928,43453,-84,-0.446
MN,Wabasha County,8741,591690,578,27641,539,29720,-39,-0.446
KY,Ballard County,2676,148860,159,6861,147,5792,-12,-0.448
MS,Chickasaw County,5810,249550,359,11680,333,10920,-26,-0.448
WI,Trempealeau County,12038,691757,728,34063,674,35469,-54,-0.449
IA,Lucas County,3119,167759,176,7119,162,6747,-14,-0.449
VT,Rutland County,25524,1468436,1308,62224,1193,61517,-115,-0.451
IN,Sullivan County,6858,375477,430,16230,399,14683,-31,-0.452
WV,Hardy County,5307,241728,294,9408,270,13279,-24,-0.452
KY,Marion County,6637,341561,380,13823,350,14398,-30,-0.452
WY,Natrona County,29188,2322572,1913,103305,1781,93644,-132,-0.452
NY,Chenango County,18334,978070,1060,46045,977,39675,-83,-0.453
PA,Bradford County,23324,1384304,1047,48147,941,43246,-106,-0.454
ND,Morton County,11893,889238,1250,68255,1196,63410,-54,-0.454
VA,Pulaski County,11647,626443,778,34481,725,39970,-53,-0.455
MS,Newton County,6980,338737,415,15398,383,13601,-32,-0.458
WY,Goshen County,4363,245596,318,13134,298,14523,-20,-0.458
NY,Madison County,25081,1723072,1781,85074,1666,94848,-115,-0.459
WI,Wood County,30483,1817839,1774,92021,1634,74636,-140,-0.459
WV,Harrison County,24761,1622508,1312,68751,1198,57458,-114,-0.46
MO,Holt County,1730,92967,94,3765,86,3896,-8,-0.462
CA,Ventura County,318012,29295134,17225,1471512,15757,1254039,-1468,-0.462
OH,Jefferson County,24258,1354515,1149,46952,1037,41904,-112,-0.462
OK,Tulsa County,216687,17624436,15114,862530,14113,729912,-1001,-0.462
NY,Westchester County,382489,68855408,22512,3075710,20738,2602490,-1774,-0.464
NJ,Atlantic County,104271,6580548,5237,299417,4752,298660,-485,-0.465
OH,Greene County,59021,4763328,6061,344671,5786,330647,-275,-0.466
CA,Colusa County,7731,474161,403,21069,367,18405,-36,-0.466
IL,Rock Island County,55661,3434071,3348,194678,3088,145826,-260,-0.467
KY,Grant County,7900,440031,767,28902,730,31659,-37,-0.468
MS,Amite County,3835,196164,238,9026,220,9738,-18,-0.469
OK,Okmulgee County,11076,545838,891,33541,839,37868,-52,-0.469
KY,Whitley County,9990,488035,827,28163,780,26141,-47,-0.47
ND,Stark County,11706,996052,1185,76939,1130,60502,-55,-0.47
KS,McPherson County,11025,750992,720,34998,668,33935,-52,-0.472
IA,Jones County,7378,455080,445,20278,410,20641,-35,-0.474
MN,Cottonwood County,4427,249439,247,11286,226,10247,-21,-0.474
KY,Hopkins County,15147,904919,792,37093,720,30895,-72,-0.475
GA,Brooks County,4628,209147,442,13959,420,14865,-22,-0.475
WV,Lincoln County,5879,274466,333,13351,305,10479,-28,-0.476
OK,Washington County,17415,1228738,1279,79812,1196,61147,-83,-0.477
UT,Duchesne County,5635,359252,404,18337,377,17038,-27,-0.479
OH,Lucas County,158388,9929773,7910,444959,7151,342500,-759,-0.479
TN,Davidson County,256026,21569771,28813,1767466,27581,1850992,-1232,-0.481
AL,Calhoun County,37377,1968333,2333,94110,2153,85119,-180,-0.482
IA,Hancock County,4152,258803,237,9598,217,8893,-20,-0.482
IL,Boone County,19472,1465441,1616,91709,1522,97808,-94,-0.483
MN,Ramsey County,204761,16286652,21241,1239206,20245,1144842,-996,-0.486
RI,Providence County,245590,15855719,13462,883628,12268,687730,-1194,-0.486
AR,White County,23023,1386324,1681,68805,1569,61758,-112,-0.486
KY,Wayne County,5954,254353,293,11009,264,10906,-29,-0.487
NY,Cortland County,16404,938314,1070,51745,990,41500,-80,-0.488
OH,Columbiana County,37849,1972065,1797,71153,1612,76698,-185,-0.489
IL,Madison County,100023,7098092,5405,288493,4915,241615,-490,-0.49
KY,Knox County,8363,362230,628,21572,587,18856,-41,-0.49
NY,Cayuga County,28577,1710778,1448,67590,1308,65910,-140,-0.49
KY,Pendleton County,4885,288461,428,16083,404,15970,-24,-0.491
OH,Franklin County,489372,35771317,32930,2063303,30508,1663834,-2422,-0.495
AL,Mobile County,134470,8190194,6050,308523,5384,249109,-666,-0.495
KY,Bourbon County,6859,370026,516,18831,482,17724,-34,-0.496
FL,Gulf County,4223,257021,455,21783,434,30747,-21,-0.497
IL,De Witt County,6030,391005,367,19042,337,15328,-30,-0.498
NE,Red Willow County,3816,222883,249,10144,230,10055,-19,-0.498
CT,Tolland County,53725,5035226,4538,320545,4270,258702,-268,-0.499
PA,Lackawanna County,82199,5162850,3739,167587,3328,151835,-411,-0.5
VA,Alleghany County,5533,308870,321,14289,293,10923,-28,-0.506
AL,Lawrence County,10656,527998,612,22502,558,22576,-54,-0.507
TX,Shelby County,7877,389969,484,21219,444,16770,-40,-0.508
GA,Wheeler County,1379,63036,96,2476,89,2284,-7,-0.508
NC,Wayne County,39408,2034701,3088,128665,2887,108677,-201,-0.51
MO,Maries County,2930,139850,243,8760,228,8415,-15,-0.512
KS,Trego County,1172,58747,53,1876,47,1988,-6,-0.512
WV,Barbour County,5072,249253,255,9719,229,9866,-26,-0.513
NC,Anson County,7592,313322,420,14456,381,13944,-39,-0.514
NY,Suffolk County,623979,64346617,25289,2263635,22078,2034318,-3211,-0.515
IN,Montgomery County,14135,790462,836,38702,763,30880,-73,-0.516
IL,Hamilton County,2900,166358,123,4215,108,3973,-15,-0.517
AL,Clay County,4435,232317,273,10205,250,10108,-23,-0.519
NY,Monroe County,295532,21980406,11719,805256,10183,571581,-1536,-0.52
CO,Otero County,5954,268394,409,16880,378,15130,-31,-0.521
OK,Creek County,22048,1519915,2035,89110,1920,99934,-115,-0.522
TX,Hockley County,7069,424783,593,21600,556,22859,-37,-0.523
MO,Livingston County,4964,263337,329,13403,303,11786,-26,-0.524
GA,Ben Hill County,4948,220313,328,10670,302,9859,-26,-0.525
WI,Dane County,218271,20017068,14600,967517,13450,831283,-1150,-0.527
MI,Marquette County,24445,1504214,1337,57125,1208,58391,-129,-0.528
KY,Webster County,4156,229407,310,12424,288,9786,-22,-0.529
IL,St. Clair County,94392,6301709,6366,372163,5866,290159,-500,-0.53
NY,Orange County,142068,11521426,9433,591864,8678,553850,-755,-0.531
MO,Barton County,3954,192688,243,8163,222,8428,-21,-0.531
OH,Crawford County,16191,783934,971,34487,885,30316,-86,-0.531
NY,Allegany County,15078,832155,847,37059,767,30238,-80,-0.531
TX,Terry County,3566,177981,253,12150,234,8906,-19,-0.533
IL,Pike County,5599,295177,233,8958,203,7685,-30,-0.536
TX,Wilbarger County,4294,387323,300,12326,277,10190,-23,-0.536
PA,Susquehanna County,15860,1026450,832,38257,747,39027,-85,-0.536
KS,Doniphan County,2608,147657,170,6073,156,5476,-14,-0.537
IA,Sioux County,11549,864591,550,26509,488,26597,-62,-0.537
KY,Clinton County,2972,114718,134,3646,118,3794,-16,-0.538
GA,Wilkes County,3159,149301,170,6170,153,7726,-17,-0.538
FL,Calhoun County,3686,176866,290,10963,270,8858,-20,-0.543
VA,Accomack County,12696,648808,765,32942,696,33758,-69,-0.543
NY,Livingston County,22556,1455307,1343,60798,1220,57833,-123,-0.545
WI,Dunn County,15409,967532,1245,51375,1161,50797,-84,-0.545
KY,Rowan County,6595,350064,608,19700,572,19923,-36,-0.546
IA,Fayette County,7130,383804,474,17700,435,15739,-39,-0.547
WV,Ritchie County,3285,177214,143,6169,125,4845,-18,-0.548
IL,Saline County,8194,463576,416,17549,371,13035,-45,-0.549
KS,Bourbon County,4906,225043,306,10131,279,9741,-27,-0.55
OK,Grant County,1452,79610,90,3370,82,3319,-8,-0.551
SC,Fairfield County,7621,361776,500,21213,458,26014,-42,-0.551
SD,Douglas County,1088,51904,54,2272,48,1618,-6,-0.551
OK,Haskell County,3440,146530,210,7524,191,6699,-19,-0.552
MT,Fallon County,1087,82413,30,1567,24,1208,-6,-0.552
IL,Fayette County,7230,387747,386,14139,346,12690,-40,-0.553
AL,Washington County,5038,289932,305,12782,277,12248,-28,-0.556
IL,Logan County,10077,599285,580,25634,524,20853,-56,-0.556
ND,Eddy County,897,46247,51,2161,46,1671,-5,-0.557
IA,Worth County,2865,168314,193,6875,177,6868,-16,-0.558
GA,DeKalb County,247455,19549983,33811,2075352,32429,1788389,-1382,-0.558
TX,Haskell County,1596,76935,145,5425,136,5577,-9,-0.564
ND,Pierce County,1597,95390,60,3323,51,2647,-9,-0.564
IL,Fulton County,12526,691544,575,26920,504,19532,-71,-0.567
IL,Winnebago County,107505,6754568,5678,330770,5067,223559,-611,-0.568
MS,Copiah County,9159,398855,491,17418,439,15826,-52,-0.568
IL,Bureau County,13332,802518,762,33774,686,32115,-76,-0.57
KS,Elk County,877,37647,50,2118,45,1670,-5,-0.57
NY,Seneca County,12290,684589,824,34756,754,33342,-70,-0.57
TX,Oldham County,701,42561,63,3161,59,2770,-4,-0.571
OH,Coshocton County,13145,654125,620,27070,545,19840,-75,-0.571
NJ,Somerset County,128933,19693532,11010,1307176,10272,960783,-738,-0.572
MT,Golden Valley County,349,14144,25,1090,23,659,-2,-0.573
GA,Decatur County,8208,373647,495,16888,448,15228,-47,-0.573
OH,Adams County,8713,428731,470,16406,420,15224,-50,-0.574
MT,Silver Bow County,12709,753582,881,54493,808,36470,-73,-0.574
OH,Cuyahoga County,491682,35760985,23492,1722515,20665,1270337,-2827,-0.575
PA,Forest County,1739,83383,103,3833,93,3459,-10,-0.575
CO,Eagle County,21207,2384750,2283,154653,2161,257636,-122,-0.575
AR,Ashley County,6257,319699,287,10739,251,9606,-36,-0.575
IL,Henderson County,2603,136749,139,5309,124,5427,-15,-0.576
TX,Nueces County,116345,6858182,8002,423786,7332,374722,-670,-0.576
KS,Gove County,1042,46028,51,2225,45,1486,-6,-0.576
NY,Chemung County,31594,1944783,1718,94187,1536,72355,-182,-0.576
WV,Monroe County,4335,203441,241,9547,216,9766,-25,-0.577
OH,Sandusky County,23821,1304074,1396,70836,1258,53638,-138,-0.579
NJ,Bergen County,366405,50532345,22824,2546073,20704,2138024,-2120,-0.579
WY,Fremont County,13563,1199472,845,39490,766,43117,-79,-0.582
TN,Shelby County,335978,23740718,17420,1142575,15462,829592,-1958,-0.583
AR,Franklin County,5141,276520,423,14324,393,15118,-30,-0.584
WV,Wetzel County,5460,326640,264,11909,232,8804,-32,-0.586
WV,Roane County,4267,208404,240,9519,215,7863,-25,-0.586
MS,Monroe County,11734,617800,685,24707,616,25402,-69,-0.588
NE,Greeley County,846,28000,52,1759,47,1828,-5,-0.591
NM,Guadalupe County,1351,50824,59,2293,51,1201,-8,-0.592
GA,Troup County,21622,1169648,1597,72192,1469,64312,-128,-0.592
WI,Kewaunee County,8093,513387,464,21366,416,19516,-48,-0.593
PA,Clarion County,13801,795272,680,29918,598,23896,-82,-0.594
WV,Taylor County,5717,330999,353,18253,319,16222,-34,-0.595
KS,Franklin County,9225,534194,733,34129,678,29112,-55,-0.596
IA,Butler County,5528,337343,307,12492,274,11644,-33,-0.597
OK,Pontotoc County,12194,713838,930,36843,857,35303,-73,-0.599
AR,Lincoln County,3000,148010,195,7538,177,5701,-18,-0.6
SC,Marion County,10154,353971,624,20679,563,17543,-61,-0.601
KY,Fleming County,4808,221915,294,10174,265,9472,-29,-0.603
PA,Warren County,15389,885696,671,34554,578,24814,-93,-0.604
CA,Napa County,52853,5766730,3716,303831,3396,317158,-320,-0.605
SD,McPherson County,827,42940,35,1844,30,1118,-5,-0.605
NY,Oneida County,86373,5288593,3760,181015,3237,143976,-523,-0.606
NY,Orleans County,14812,777780,862,34168,772,30288,-90,-0.608
MN,Stearns County,57221,4182507,4584,222418,4236,208793,-348,-0.608
CA,Alameda County,619312,70690273,49635,4750596,45864,4434831,-3771,-0.609
MN,Yellow Medicine County,3770,287953,234,12012,211,7893,-23,-0.61
IL,Shelby County,8156,478710,504,21811,454,20679,-50,-0.613
TX,Erath County,11563,689560,1199,50022,1128,51336,-71,-0.614
OH,Mahoning County,88442,5093030,4559,212735,4016,180668,-543,-0.614
IL,Kankakee County,39723,2510057,2175,113634,1931,91892,-244,-0.614
TX,El Paso County,285648,13819770,16109,735751,14348,657339,-1761,-0.616
IN,Scott County,8113,416326,602,22996,552,21720,-50,-0.616
PA,Cambria County,51566,2899860,2005,99635,1687,67620,-318,-0.617
NJ,Morris County,196004,30808198,14030,1765885,12821,1505246,-1209,-0.617
KY,Ohio County,7605,374054,446,15742,399,14526,-47,-0.618
TX,Gonzales County,6959,407037,441,19526,398,19327,-43,-0.618
PA,Crawford County,31206,1695849,1490,66604,1297,53586,-193,-0.618
IA,Clinton County,17721,1058372,1031,45746,921,39616,-110,-0.621
VA,Bath County,1771,104134,113,4948,102,4658,-11,-0.621
SC,Williamsburg County,9802,371692,611,18046,550,18019,-61,-0.622
WY,Uinta County,7077,509964,485,31788,441,22104,-44,-0.622
CO,Yuma County,3371,174806,214,8859,193,8539,-21,-0.623
GA,Pulaski County,2730,137966,216,8713,199,8076,-17,-0.623
KS,Shawnee County,66622,4301507,3469,176812,3054,135988,-415,-0.623
AL,Choctaw County,4010,208430,185,7378,160,6056,-25,-0.623
GA,Jenkins County,2244,91843,165,4795,151,4406,-14,-0.624
MN,Houston County,7682,508397,446,25105,398,17932,-48,-0.625
WY,Washakie County,2875,193724,180,7868,162,8388,-18,-0.626
AL,Jefferson County,225896,18762608,13629,870315,12207,737503,-1422,-0.629
TX,Jones County,4757,242821,525,23070,495,19981,-30,-0.631
GA,Lowndes County,33402,1890485,3636,150388,3425,149489,-211,-0.632
KY,Johnson County,6166,316151,375,15697,336,12967,-39,-0.633
MN,Freeborn County,12000,723106,650,31630,574,24949,-76,-0.633
CO,Rio Blanco County,2054,138404,175,9920,162,8816,-13,-0.633
MO,Shannon County,2370,87570,168,4804,153,4809,-15,-0.633
KS,Neosho County,5529,285730,340,10696,305,9836,-35,-0.633
IL,Livingston County,13568,876999,838,38918,752,29251,-86,-0.634
VA,Scott County,6623,316610,339,11046,297,10604,-42,-0.634
KY,Union County,4577,249589,251,9762,222,7340,-29,-0.634
NC,Graham County,2681,120013,137,4699,120,5559,-17,-0.634
MT,Valley County,2840,168267,165,7062,147,7225,-18,-0.634
MS,Pike County,12615,574390,772,29161,692,26815,-80,-0.634
MO,Cole County,28716,2063653,1982,96532,1800,76716,-182,-0.634
MO,Montgomery County,4085,206281,283,10675,257,10314,-26,-0.636
IN,Jennings County,10057,503366,714,25944,650,22856,-64,-0.636
TX,Robertson County,5648,288746,481,18738,445,19288,-36,-0.637
MT,Phillips County,1570,69375,56,2153,46,2005,-10,-0.637
MS,Lowndes County,19140,1079813,1467,75192,1345,61301,-122,-0.637
PA,Sullivan County,2351,135706,137,5706,122,6042,-15,-0.638
VA,York County,23166,2135691,3454,215470,3306,206532,-148,-0.639
MT,Cascade County,30976,1864635,2406,112362,2207,97744,-199,-0.642
VA,Sussex County,3272,156381,287,9951,266,9846,-21,-0.642
CA,Mariposa County,5905,355435,579,27889,541,29406,-38,-0.644
WV,Wood County,31173,1838132,1476,73661,1275,54564,-201,-0.645
IA,Lee County,12558,723501,630,27287,549,22075,-81,-0.645
NC,Duplin County,16414,740842,1069,38095,963,34907,-106,-0.646
NY,Wayne County,35591,2143340,2165,102826,1935,98634,-230,-0.646
NY,Wyoming County,14704,856465,848,35321,753,30817,-95,-0.646
TX,Webb County,88442,4118902,2790,126002,2218,99951,-572,-0.647
IL,Washington County,5565,367738,333,14781,297,15165,-36,-0.647
TX,Frio County,4930,236918,327,15524,295,12247,-32,-0.649
KS,Barber County,1696,81079,93,3528,82,3728,-11,-0.649
MS,Leake County,6629,296417,421,14893,378,14321,-43,-0.649
TX,Cameron County,131598,5621633,5463,232009,4609,212208,-854,-0.649
KY,Morgan County,3384,144523,155,6061,133,5053,-22,-0.65
PA,Philadelphia County,526508,30450272,35981,2321630,32560,1946833,-3421,-0.65
WV,Calhoun County,2000,97943,83,2938,70,2304,-13,-0.65
IN,Marion County,347881,21470872,28032,1595362,25767,1253162,-2265,-0.651
MI,Calhoun County,47800,2806165,2855,133862,2544,124271,-311,-0.651
MA,Hampden County,177563,12132779,7531,410815,6369,310142,-1162,-0.654
TX,Dimmit County,3053,156929,183,7460,163,6301,-20,-0.655
IA,Winneshiek County,7791,490697,410,19655,359,18233,-51,-0.655
MO,Washington County,6862,294048,505,17126,460,16920,-45,-0.656
IL,Tazewell County,50926,3735323,3061,188807,2727,143037,-334,-0.656
WV,Lewis County,6057,329074,321,13333,281,10786,-40,-0.66
TX,Wharton County,14796,847384,841,36154,743,36484,-98,-0.662
NY,Montgomery County,18255,980587,1180,49572,1059,41572,-121,-0.663
IN,Marshall County,17114,1030021,1095,57924,981,47419,-114,-0.666
NE,Knox County,3147,157207,145,7029,124,6057,-21,-0.667
OK,Cotton County,1800,85863,128,4675,116,4055,-12,-0.667
MI,Schoolcraft County,3146,161854,152,6161,131,6180,-21,-0.668
IA,Wapello County,12085,664325,875,35212,794,29085,-81,-0.67
TN,Obion County,10770,525942,662,22404,589,21524,-73,-0.678
PA,Venango County,20027,1045850,895,33687,759,33180,-136,-0.679
CA,Orange County,1192078,125315037,66496,5333233,58396,4863167,-8100,-0.679
MI,Wayne County,615893,37139484,31991,1773074,27799,1476362,-4192,-0.681
IA,Des Moines County,15116,921447,849,40961,746,32456,-103,-0.681
KY,McCreary County,3812,142529,161,5192,135,4298,-26,-0.682
CT,New Haven County,329066,27034852,18310,1319340,16063,1020865,-2247,-0.683
IL,LaSalle County,43361,2742201,2453,122620,2157,105446,-296,-0.683
TX,Uvalde County,9084,448894,590,24325,528,23524,-62,-0.683
IA,Henry County,7019,408239,461,19213,413,17438,-48,-0.684
MT,Powell County,2046,117532,170,6867,156,7126,-14,-0.684
MS,Benton County,2478,99273,243,7869,226,7481,-17,-0.686
AL,Dale County,14414,744455,2269,102323,2170,94792,-99,-0.687
KY,Mason County,5806,338659,412,17926,372,15093,-40,-0.689
PA,Lycoming County,43707,2558950,1936,101958,1635,73580,-301,-0.689
KS,Rooks County,1884,69277,90,3266,77,2462,-13,-0.69
OK,Choctaw County,4196,175770,323,10139,294,10414,-29,-0.691
OH,Wood County,47149,3491569,4338,215204,4012,212838,-326,-0.691
KS,Woodson County,1156,49714,56,1963,48,1651,-8,-0.692
OH,Wayne County,43153,2667131,2334,104005,2035,92588,-299,-0.693
MT,Fergus County,4329,241687,288,11971,258,13252,-30,-0.693
OH,Gallia County,9525,538989,447,18140,381,16911,-66,-0.693
TX,Val Verde County,16295,793999,1193,63658,1080,49158,-113,-0.693
GA,Jefferson County,5327,235057,297,9319,260,10295,-37,-0.695
NY,Tioga County,18684,1165723,1323,58973,1193,51452,-130,-0.696
VA,Smyth County,9994,467180,477,16561,407,13958,-70,-0.7
PA,Fulton County,5705,322026,298,16050,258,11063,-40,-0.701
KS,Wyandotte County,52603,2472257,5306,230777,4937,196553,-369,-0.701
MS,Covington County,6128,282283,399,13758,356,12215,-43,-0.702
GA,Sumter County,8963,413114,531,22742,468,19583,-63,-0.703
OK,McCurtain County,9501,415569,500,17771,433,16060,-67,-0.705
NY,Nassau County,567572,75398637,29902,3266495,25896,2627221,-4006,-0.706
NY,Cattaraugus County,27586,1472647,1440,65141,1245,54659,-195,-0.707
IL,Ford County,5085,314102,361,17790,325,12353,-36,-0.708
CA,Imperial County,61426,2883438,2673,116467,2238,83986,-435,-0.708
MT,Prairie County,424,21545,25,938,22,714,-3,-0.708
MS,Perry County,3522,163766,274,11613,249,9560,-25,-0.71
KS,Sedgwick County,184693,13665707,10251,568541,8940,440075,-1311,-0.71
NY,Onondaga County,179844,13222164,8755,655834,7479,414774,-1276,-0.71
KS,Reno County,22105,1315464,1290,59792,1133,55583,-157,-0.71
MS,Neshoba County,9148,445615,514,17768,449,16182,-65,-0.711
NC,Tyrrell County,1262,47867,74,2424,65,1728,-9,-0.713
MO,Carroll County,3226,173678,161,5726,138,4442,-23,-0.713
ND,Burleigh County,36303,3208311,2770,158312,2510,132546,-260,-0.716
NE,Garden County,698,28275,36,1360,31,439,-5,-0.716
GA,Screven County,4192,198056,266,9197,236,9170,-30,-0.716
KY,Lyon County,2508,149442,245,10106,227,14633,-18,-0.718
MN,Pennington County,5429,338982,384,20355,345,13215,-39,-0.718
KS,Dickinson County,6963,380769,568,24116,518,22259,-50,-0.718
IN,Adams County,12371,719645,582,23350,493,18035,-89,-0.719
IA,Plymouth County,9593,711232,631,33995,562,25574,-69,-0.719
RI,Newport County,32927,3253954,3027,243831,2789,271974,-238,-0.723
TX,Knox County,1105,47713,80,3095,72,3093,-8,-0.724
MN,Red Lake County,1512,90371,92,3762,81,3153,-11,-0.728
OH,Putnam County,13737,976374,563,25146,463,19199,-100,-0.728
MI,Gratiot County,13458,726225,897,33297,799,31318,-98,-0.728
IA,O'Brien County,5330,357006,348,12903,309,12698,-39,-0.732
IL,Stephenson County,17850,1016895,950,47899,819,29809,-131,-0.734
KY,Carroll County,3537,187198,295,11493,269,9902,-26,-0.735
FL,Lafayette County,1899,87460,152,4843,138,5136,-14,-0.737
SD,Gregory County,1625,81932,67,2128,55,2142,-12,-0.738
PA,Snyder County,14749,833256,801,35625,692,28412,-109,-0.739
IL,Jo Daviess County,9443,608481,602,27047,532,34910,-70,-0.741
SD,Jackson County,810,32636,56,1865,50,1442,-6,-0.741
NE,Brown County,1080,43834,62,2505,54,2621,-8,-0.741
SC,Orangeburg County,28098,1276804,1721,66364,1512,56842,-209,-0.744
NE,Kearney County,2420,161781,186,7657,168,6505,-18,-0.744
KS,Linn County,3355,175108,276,10732,251,14276,-25,-0.745
OK,Muskogee County,19998,1067975,1526,60025,1377,53669,-149,-0.745
NY,Richmond County,182437,14852529,9912,733283,8544,461465,-1368,-0.75
ND,Sargent County,1595,102624,105,4492,93,4217,-12,-0.752
WV,Mercer County,19157,924086,979,36376,835,29525,-144,-0.752
TN,Crockett County,4775,241187,330,12785,294,12777,-36,-0.754
MO,Caldwell County,3043,176470,243,10353,220,8613,-23,-0.756
KY,Elliott County,1718,75819,93,2968,80,2280,-13,-0.757
NE,Boone County,2114,127337,102,4209,86,3512,-16,-0.757
SD,Hamlin County,1978,128388,147,6664,132,6859,-15,-0.758
OH,Hamilton County,313485,26584394,19799,1414192,17416,1114524,-2383,-0.76
WV,Wyoming County,5517,263366,225,9515,183,6293,-42,-0.761
WV,Hancock County,11437,629479,692,27521,605,22290,-87,-0.761
TX,Harris County,1519470,120110671,93935,6744329,82339,5181538,-11596,-0.763
NJ,Essex County,285587,29889325,21129,1779338,18948,1454366,-2181,-0.764
GA,Tift County,12684,687246,916,38016,819,30694,-97,-0.765
TN,Lauderdale County,7454,331196,458,15243,401,12098,-57,-0.765
IL,Adams County,25580,1683865,1088,48162,892,39405,-196,-0.766
MO,St. Clair County,2862,120492,210,6496,188,6725,-22,-0.769
TX,Starr County,20417,740898,683,26252,526,18773,-157,-0.769
IL,Union County,6215,345137,291,11964,243,10156,-48,-0.772
NY,Steuben County,35641,2251443,1952,119238,1677,92282,-275,-0.772
IN,Gibson County,12568,773991,760,37314,663,29135,-97,-0.772
GA,Taylor County,2458,115006,179,6479,160,5354,-19,-0.773
IN,Franklin County,8396,571270,584,24953,519,26793,-65,-0.774
KY,Clay County,4878,196594,258,8175,220,5820,-38,-0.779
AL,Barbour County,7176,322664,445,16473,389,15215,-56,-0.78
MN,Murray County,3333,199261,181,9625,155,7623,-26,-0.78
MN,Lac qui Parle County,2693,173083,122,5636,101,4597,-21,-0.78
CA,San Francisco County,380632,63823930,37668,5557260,34695,4234532,-2973,-0.781
ND,Burke County,896,68202,34,2121,27,1608,-7,-0.781
VA,Rappahannock County,2818,245346,222,12887,200,17236,-22,-0.781
MS,Smith County,4722,243605,314,10900,277,11823,-37,-0.784
KS,Rawlins County,1021,50484,32,1000,24,1691,-8,-0.784
KS,Jackson County,4845,272116,330,14695,292,13486,-38,-0.784
CO,Prowers County,3821,180931,234,9560,204,7013,-30,-0.785
PA,Mercer County,42568,2412020,1928,91427,1593,70321,-335,-0.787
TX,Dallas County,891292,77694769,74763,5026924,67752,4748091,-7011,-0.787
MO,Stoddard County,9518,506023,601,21310,526,19000,-75,-0.788
MS,Carroll County,3295,139505,246,10107,220,9556,-26,-0.789
VA,Brunswick County,5059,232514,338,14134,298,14635,-40,-0.791
TX,Matagorda County,12099,753905,915,51285,819,44546,-96,-0.793
IL,Sangamon County,79580,6127960,4114,229595,3482,167786,-632,-0.794
NY,Essex County,14108,854320,983,66701,871,52631,-112,-0.794
TN,Hardeman County,7792,322745,482,15504,420,14982,-62,-0.796
CA,Monterey County,153085,11671143,9275,867995,8057,595097,-1218,-0.796
NE,Polk County,2010,132657,127,5570,111,4585,-16,-0.796
IA,Carroll County,8027,604628,449,22007,385,16523,-64,-0.797
KY,Calloway County,11421,637555,945,33771,854,35039,-91,-0.797
AR,Sevier County,4767,212191,273,9513,235,8016,-38,-0.797
GA,Cobb County,254638,24794472,30250,2040077,28221,1741479,-2029,-0.797
MO,Pettis County,14517,743658,1023,38836,907,35363,-116,-0.799
IA,Greene County,3378,191512,190,8535,163,6470,-27,-0.799
CT,New London County,107353,8825677,6941,453399,6076,366859,-865,-0.806
MI,Chippewa County,12632,621087,688,29071,586,27765,-102,-0.807
NC,Scotland County,10379,468621,694,25318,610,20733,-84,-0.809
VA,Charlotte County,4074,189508,259,8883,226,9555,-33,-0.81
IL,Macon County,38715,2507237,1933,112445,1619,78821,-314,-0.811
NY,St. Lawrence County,35640,2007254,1521,73068,1232,65221,-289,-0.811
TX,Jackson County,4930,296364,379,17659,339,16100,-40,-0.811
WV,Pleasants County,2587,160122,117,4511,96,3660,-21,-0.812
NE,Buffalo County,17186,1230852,1303,77469,1163,54678,-140,-0.815
NJ,Union County,211779,21886409,15402,1186889,13672,1101577,-1730,-0.817
MN,Steele County,14653,983468,920,43420,800,39708,-120,-0.819
IL,Douglas County,7788,485271,536,24102,472,20704,-64,-0.822
IA,Muscatine County,16287,1067535,1005,52058,871,37814,-134,-0.823
MS,Jasper County,5470,254251,378,13312,333,12261,-45,-0.823
IA,Cerro Gordo County,16429,1133139,1033,51890,897,45961,-136,-0.828
IL,Marion County,14110,750891,759,32708,642,28912,-117,-0.829
SC,Calhoun County,4820,271864,382,15310,342,16855,-40,-0.83
IL,Moultrie County,5292,365201,400,15913,356,15766,-44,-0.831
MN,Benton County,14549,940897,1875,86504,1754,72489,-121,-0.832
TX,Nolan County,4807,263489,384,18319,344,15651,-40,-0.832
ND,McIntosh County,1081,48215,38,1781,29,1195,-9,-0.833
MS,Wayne County,6600,317180,340,12310,285,10394,-55,-0.833
CT,Hartford County,356776,31895948,19061,1470374,16087,1047692,-2974,-0.834
GA,McDuffie County,7074,346208,476,19034,417,19131,-59,-0.834
MS,Montgomery County,3354,150873,224,8439,196,7125,-28,-0.835
NM,Cibola County,7286,303704,476,16472,415,12781,-61,-0.837
KS,Ottawa County,2150,112802,147,6867,129,5854,-18,-0.837
ND,Bowman County,1194,92253,41,2063,31,1392,-10,-0.838
MT,Pondera County,2268,104391,137,5157,118,3807,-19,-0.838
NE,Morrill County,1664,85344,110,4226,96,3965,-14,-0.841
GA,Seminole County,2494,115098,182,6072,161,5785,-21,-0.842
AR,Hempstead County,6527,283389,407,15574,352,12551,-55,-0.843
CO,Summit County,12453,1178427,1892,118895,1787,184291,-105,-0.843
MS,Marion County,7475,290024,440,13876,377,13939,-63,-0.843
CA,Santa Cruz County,102561,10416906,6811,532984,5944,518792,-867,-0.845
GA,Richmond County,63016,3131556,7147,328446,6613,286633,-534,-0.847
NY,Chautauqua County,45935,2450941,1909,83373,1520,66570,-389,-0.847
IA,Palo Alto County,3408,186949,208,8707,179,7128,-29,-0.851
MN,Chippewa County,4694,287301,321,13456,281,11793,-40,-0.852
AR,Woodruff County,1993,87724,120,4304,103,3185,-17,-0.853
AR,Union County,13365,855674,723,41026,609,31284,-114,-0.853
AL,Butler County,6313,287883,341,11655,287,11470,-54,-0.855
KY,Fayette County,108789,8427504,9277,544938,8347,451070,-930,-0.855
TX,Mills County,1636,109736,107,4638,93,4732,-14,-0.856
IN,Grant County,23225,1170734,1272,53258,1073,40227,-199,-0.857
SD,Potter County,931,62577,38,1630,30,1304,-8,-0.859
CA,Humboldt County,44348,2697164,2945,130408,2563,104319,-382,-0.861
TX,Victoria County,31584,2092373,2099,114108,1827,89252,-272,-0.861
GA,Twiggs County,2669,114839,236,8414,213,7155,-23,-0.862
AR,Clark County,6265,331713,527,19698,473,15490,-54,-0.862
TX,Maverick County,19802,811341,869,32697,698,24751,-171,-0.864
SD,Spink County,2311,140264,133,6369,113,5961,-20,-0.865
MI,Saginaw County,71307,4096078,3788,182774,3168,142673,-620,-0.869
CA,San Mateo County,305494,60522998,26450,3976835,23794,3500170,-2656,-0.869
NE,Webster County,1265,61735,82,2847,71,2493,-11,-0.87
IL,Wabash County,4132,273060,219,8364,183,6713,-36,-0.871
MA,Middlesex County,624151,86407105,48934,4974179,43495,3823209,-5439,-0.871
AR,Lafayette County,1947,89508,154,4780,137,4472,-17,-0.873
NJ,Mercer County,136411,15814379,9782,991895,8591,682190,-1191,-0.873
SD,Davison County,7560,497954,542,24686,476,20777,-66,-0.873
TX,Baylor County,1144,62835,70,2676,60,2036,-10,-0.874
IA,Chickasaw County,4678,299165,244,9052,203,7691,-41,-0.876
IL,Marshall County,4682,287816,336,13826,295,12445,-41,-0.876
MN,Stevens County,3420,241462,225,9194,195,8948,-30,-0.877
IA,Clay County,6381,439750,440,20651,384,17307,-56,-0.878
PA,Indiana County,29077,1737124,1476,68347,1220,50129,-256,-0.88
IN,LaGrange County,13407,856136,868,45407,750,42280,-118,-0.88
NE,Jefferson County,2713,158480,158,6922,134,5362,-24,-0.885
OK,Beckham County,6201,384265,501,24589,446,21412,-55,-0.887
SD,Faulk County,788,45243,37,1543,30,1718,-7,-0.888
OH,Pike County,8901,447715,547,23466,468,17947,-79,-0.888
IA,Hardin County,6186,338942,419,20355,364,15925,-55,-0.889
OK,Blaine County,2925,245215,219,13710,193,10148,-26,-0.889
OH,Holmes County,14121,855002,693,30110,567,24284,-126,-0.892
GA,Macon County,3363,141068,243,8048,213,6995,-30,-0.892
MO,Ripley County,3910,150974,283,8446,248,9736,-35,-0.895
AR,Scott County,3016,123584,216,6808,189,7473,-27,-0.895
TX,Angelina County,27921,1549365,1824,81855,1572,69909,-252,-0.903
IA,Wright County,4647,265328,285,12539,243,9946,-42,-0.904
CA,Los Angeles County,3732877,330740878,154210,11436416,120440,8511638,-33770,-0.905
OH,Monroe County,5071,350981,229,10368,183,9661,-46,-0.907
KS,Graham County,991,44442,52,1452,43,1367,-9,-0.908
PA,Union County,13691,976748,967,51419,842,48526,-125,-0.913
KY,Henderson County,15661,941033,887,45762,744,28970,-143,-0.913
NM,San Miguel County,8968,349539,565,21057,483,19052,-82,-0.914
IA,Floyd County,5798,347821,407,18126,354,14154,-53,-0.914
OH,Harrison County,5243,311144,331,13585,283,11300,-48,-0.916
OH,Noble County,4365,250675,226,8785,186,8113,-40,-0.916
NY,Yates County,8914,504204,575,26243,493,25960,-82,-0.92
IL,Randolph County,10975,655467,600,28627,499,20132,-101,-0.92
TX,Tom Green County,39535,2663028,3586,160994,3222,144999,-364,-0.921
NE,Hitchcock County,976,42962,63,1833,54,2499,-9,-0.922
NE,Platte County,13120,850423,841,40405,720,31749,-121,-0.922
NE,Loup County,217,7019,23,831,21,1365,-2,-0.922
IL,Jersey County,8016,518807,561,22959,487,20713,-74,-0.923
MT,Glacier County,3894,159345,227,11901,191,7164,-36,-0.924
CT,Fairfield County,357116,69375082,21235,3017316,17929,2869252,-3306,-0.926
IL,Crawford County,7001,422279,310,14813,245,10655,-65,-0.928
MS,Holmes County,5702,188692,306,9304,253,7929,-53,-0.929
TX,Wichita County,41031,2543018,3529,168904,3146,156180,-383,-0.933
TX,Marion County,2995,139390,308,11388,280,12645,-28,-0.935
PA,Erie County,103508,6196719,3881,196776,2913,142125,-968,-0.935
ND,Renville County,958,65003,53,4473,44,2608,-9,-0.939
FL,Leon County,93546,6558668,8667,397498,7786,372634,-881,-0.942
TX,Nacogdoches County,19086,1101243,1538,57494,1358,54719,-180,-0.943
KS,Montgomery County,10395,534447,692,26827,594,22306,-98,-0.943
MO,Boone County,59518,4530725,5176,259801,4614,219601,-562,-0.944
MN,Faribault County,5490,301098,318,15077,266,10325,-52,-0.947
MA,Hampshire County,57798,4716596,4734,256570,4186,230145,-548,-0.948
IA,Osceola County,2314,126078,145,7125,123,4742,-22,-0.951
TX,Scurry County,5044,356512,375,22837,327,19159,-48,-0.952
NJ,Hudson County,259098,20659718,27819,2821664,25347,2203853,-2472,-0.954
MD,Prince George's County,356130,23537391,30075,1664466,26676,1291788,-3399,-0.954
KS,Lincoln County,1148,51783,58,1343,47,1500,-11,-0.958
GA,Dodge County,5638,252816,357,10898,303,8108,-54,-0.958
MS,Clay County,6562,300132,382,12730,319,13935,-63,-0.96
WI,Grant County,18178,975965,1182,49652,1007,41075,-175,-0.963
ND,Logan County,727,26314,36,1599,29,1415,-7,-0.963
IL,DeKalb County,35265,2401855,3293,148854,2953,135873,-340,-0.964
MN,Winona County,17923,1190034,1124,77390,951,37671,-173,-0.965
NM,Chaves County,19472,993912,1173,58864,985,46883,-188,-0.965
AR,Columbia County,6941,394319,410,16416,343,12197,-67,-0.965
IA,Black Hawk County,46826,3191971,2880,147202,2427,112220,-453,-0.967
MS,Calhoun County,4651,193502,231,7273,186,6068,-45,-0.968
NE,Scotts Bluff County,12879,729436,793,34164,668,28508,-125,-0.971
AL,Sumter County,3699,144451,212,6952,176,6070,-36,-0.973
OH,Allen County,37524,2240492,2192,100147,1826,78006,-366,-0.975
IA,Marshall County,14405,890149,934,42598,793,31629,-141,-0.979
MS,Lafayette County,14989,1227316,1540,77257,1393,91943,-147,-0.981
AR,Arkansas County,6006,332596,329,12397,270,10647,-59,-0.982
NE,Johnson County,1627,82198,90,3548,74,2869,-16,-0.983
ND,Traill County,2948,224214,216,10712,187,10488,-29,-0.984
IA,Sac County,3860,237337,210,8446,172,7749,-38,-0.984
NC,Hertford County,6505,300684,401,14117,337,11297,-64,-0.984
IL,Lake County,262119,34324987,17962,1771734,15377,1338450,-2585,-0.986
AL,Franklin County,9332,447192,600,22586,508,19713,-92,-0.986
HI,Honolulu County,386851,29283945,24483,1419291,20668,1200118,-3815,-0.986
ID,Lewis County,1317,63146,151,5716,138,6161,-13,-0.987
NM,De Baca County,608,39500,29,1407,23,720,-6,-0.987
WV,Gilmer County,1921,107858,116,4341,97,3467,-19,-0.989
MO,Harrison County,2923,123320,149,5635,120,4190,-29,-0.992
ID,Latah County,12056,804393,1415,58567,1295,58908,-120,-0.995
KS,Wilson County,3015,154471,174,6202,144,5935,-30,-0.995
NC,Robeson County,37255,1490227,1837,64452,1465,48079,-372,-0.999
KY,Christian County,20792,1066215,3671,129429,3463,115877,-208,-1.0
KS,Anderson County,2696,132852,163,5767,136,5843,-27,-1.001
AL,Lowndes County,3688,153827,291,10278,254,9619,-37,-1.003
MO,Perry County,7146,397857,385,15407,313,13616,-72,-1.008
IN,Jay County,7529,353918,400,12801,324,10297,-76,-1.009
KS,Cowley County,11781,661904,765,28876,646,27858,-119,-1.01
NY,Albany County,120730,10474028,9564,655639,8341,539692,-1223,-1.013
OK,Harper County,1183,58992,49,1873,37,1314,-12,-1.014
IL,Richland County,5913,318411,324,13407,264,10168,-60,-1.015
AR,Howard County,4235,202232,291,10716,248,9046,-43,-1.015
NC,Bertie County,6102,303139,365,11693,303,9801,-62,-1.016
TX,Crockett County,1176,76769,73,3941,61,2444,-12,-1.02
IL,Vermilion County,26712,1410354,1338,57119,1065,38107,-273,-1.022
GA,Dooly County,2927,137361,216,8865,186,5425,-30,-1.025
AL,Pickens County,5852,292653,295,11397,235,9422,-60,-1.025
KY,Hickman County,1458,73947,100,3598,85,2664,-15,-1.029
WV,Logan County,9317,461372,408,15581,312,10856,-96,-1.03
MN,Kandiyohi County,16765,1137275,1038,50099,865,46914,-173,-1.032
KS,Douglas County,38652,2886843,3909,196567,3509,181475,-400,-1.035
PA,Cameron County,1930,91144,86,2684,66,2443,-20,-1.036
MT,Chouteau County,1736,88881,125,5793,107,4261,-18,-1.037
SC,Barnwell County,6642,323169,376,13344,307,10870,-69,-1.039
SC,Bamberg County,4133,183039,267,9369,224,8598,-43,-1.04
IA,Crawford County,6241,354185,388,15219,323,11859,-65,-1.041
MO,Adair County,7372,399881,653,25399,576,22942,-77,-1.044
CA,Santa Barbara County,158913,14271591,9761,701225,8098,641186,-1663,-1.046
NY,Lewis County,9613,513773,521,23084,420,19643,-101,-1.051
AR,Poinsett County,6839,312297,513,19180,441,13612,-72,-1.053
MN,Roseau County,5984,380384,305,14987,242,10786,-63,-1.053
KY,Perry County,7781,394208,389,14603,307,12120,-82,-1.054
SD,Haakon County,758,45046,38,699,30,938,-8,-1.055
IA,Davis County,2838,148986,159,8299,129,6003,-30,-1.057
MN,Rock County,3579,223448,203,8500,165,6990,-38,-1.062
FL,Hardee County,7530,333691,579,20545,499,18125,-80,-1.062
KY,McLean County,3103,168268,187,6095,154,6295,-33,-1.063
MT,Sheridan County,1502,85262,88,4061,72,2798,-16,-1.065
MN,Martin County,8246,474679,425,19458,337,13118,-88,-1.067
TX,Jim Wells County,12900,669774,921,40825,783,32987,-138,-1.07
NE,Hall County,23039,1506138,1664,76806,1417,54894,-247,-1.072
IA,Calhoun County,3639,213579,227,10140,188,8659,-39,-1.072
AR,Pulaski County,136703,10618022,10704,564337,9236,430216,-1468,-1.074
AR,Ouachita County,7541,376812,461,18552,380,15103,-81,-1.074
PA,Wyoming County,10686,684802,719,32046,604,24523,-115,-1.076
TX,Titus County,10411,565945,763,31684,651,29041,-112,-1.076
AR,Clay County,4631,199151,327,11052,277,9341,-50,-1.08
WV,Fayette County,13189,610097,788,27664,645,24730,-143,-1.084
KS,Ellsworth County,2119,116333,125,4567,102,3281,-23,-1.085
WV,Marshall County,11433,704301,636,30527,512,22402,-124,-1.085
VT,Chittenden County,67272,5835074,5157,305322,4426,275094,-731,-1.087
KS,Sheridan County,1012,43855,38,1701,27,859,-11,-1.087
IL,Perry County,7080,385757,398,14587,321,15162,-77,-1.088
TX,Runnels County,3492,186994,261,11514,223,10975,-38,-1.088
WI,Milwaukee County,346782,22130616,20458,1384211,16681,889499,-3777,-1.089
IL,Bond County,5506,319840,354,14734,294,12394,-60,-1.09
NJ,Passaic County,195065,13456805,12342,820874,10214,621325,-2128,-1.091
NJ,Cumberland County,52438,2926656,2572,116872,2000,96687,-572,-1.091
AZ,Coconino County,43997,3020851,4959,247737,4479,270112,-480,-1.091
KS,Comanche County,641,30234,27,1372,20,1062,-7,-1.092
KS,Sumner County,8006,470589,617,25233,529,23103,-88,-1.099
TX,Wheeler County,1724,98924,123,5072,104,5107,-19,-1.102
MO,Howard County,3443,183507,251,9678,213,9560,-38,-1.104
AL,Marengo County,6401,334692,393,17647,322,11895,-71,-1.109
SD,Hanson County,1530,100244,107,6247,90,4755,-17,-1.111
MS,Yazoo County,7457,319822,383,14131,300,10840,-83,-1.113
IA,Monona County,3321,188009,200,8140,163,7637,-37,-1.114
AR,Crittenden County,15789,782221,1114,44482,938,46137,-176,-1.115
NE,Dodge County,13635,827193,918,44102,766,38587,-152,-1.115
SD,Hughes County,6906,494710,543,30631,466,21644,-77,-1.115
AR,Lee County,2144,123622,169,4454,145,3706,-24,-1.119
IN,White County,9271,523207,772,33002,668,31632,-104,-1.122
IA,Montgomery County,3735,208313,269,12192,227,9268,-42,-1.124
AL,Monroe County,6314,305923,342,15260,271,11819,-71,-1.124
SD,Walworth County,2131,136716,114,4875,90,4350,-24,-1.126
IL,Cook County,2011039,178442056,100145,8657421,77478,5723827,-22667,-1.127
AR,Chicot County,3014,133132,209,6815,175,7136,-34,-1.128
MI,Washtenaw County,127037,12703939,12465,836654,11032,743866,-1433,-1.128
WV,Monongalia County,32214,2541792,3567,201790,3202,172762,-365,-1.133
MT,Daniels County,706,42971,28,1382,20,846,-8,-1.133
TN,Haywood County,6333,243587,408,14438,336,11637,-72,-1.137
NC,Halifax County,16608,733281,1043,38148,854,31076,-189,-1.138
NE,Chase County,1406,82057,68,3368,52,2412,-16,-1.138
IL,Warren County,6235,347080,422,18909,351,14150,-71,-1.139
TX,Brooks County,2275,80047,142,4768,116,4112,-26,-1.143
VA,Wise County,10571,507520,660,23602,539,18645,-121,-1.145
IL,Hancock County,6895,395245,431,17377,352,14196,-79,-1.146
ND,Dickey County,1913,106191,112,5299,90,4391,-22,-1.15
IL,DuPage County,359458,41385496,29457,2721910,25312,2047784,-4145,-1.153
KY,Lawrence County,4312,214400,302,11593,252,8708,-50,-1.16
NY,Broome County,71905,4423529,3698,185997,2864,126101,-834,-1.16
MN,Blue Earth County,23438,1572690,2399,105243,2127,95065,-272,-1.161
OK,Kiowa County,2584,109800,182,5360,152,5940,-30,-1.161
VA,Dickenson County,3870,179335,202,6701,157,4795,-45,-1.163
OK,Caddo County,8068,405570,609,24795,515,21933,-94,-1.165
KS,Stanton County,686,44745,31,1742,23,763,-8,-1.166
KS,Lyon County,11452,628499,784,30014,650,26499,-134,-1.17
KY,Floyd County,9901,472130,604,22100,488,18247,-116,-1.172
KS,Meade County,1449,93898,105,5245,88,4768,-17,-1.173
FL,Hendry County,12012,555928,1150,40697,1009,38173,-141,-1.174
MN,Jackson County,4075,243876,236,9136,188,7018,-48,-1.178
ND,Griggs County,932,59508,38,1837,27,980,-11,-1.18
WV,Boone County,6441,321556,333,13289,257,9326,-76,-1.18
SD,Grant County,2874,182450,154,8557,120,5900,-34,-1.183
IA,Mahaska County,7586,494659,517,23268,427,19285,-90,-1.186
SD,Codington County,10753,739580,740,33285,612,32375,-128,-1.19
AL,Montgomery County,75008,4705233,5533,315066,4639,232931,-894,-1.192
NE,Rock County,502,22159,35,1294,29,1152,-6,-1.195
KS,Thomas County,2846,164805,232,9399,198,9487,-34,-1.195
CA,Yolo County,68867,6029340,6737,406766,5914,357787,-823,-1.195
KS,Hodgeman County,669,35846,37,1721,29,1112,-8,-1.196
MI,Ingham County,95360,6529677,9008,487223,7866,360003,-1142,-1.198
IN,Vigo County,35904,2043066,2400,106523,1970,80058,-430,-1.198
OH,Henry County,11258,684399,679,28179,544,20629,-135,-1.199
AL,Hale County,4832,213670,351,12970,293,12272,-58,-1.2
SD,Corson County,917,36321,69,2976,58,1806,-11,-1.2
NM,Luna County,8077,289169,546,29646,449,14796,-97,-1.201
ND,Walsh County,4243,266457,253,14254,202,7769,-51,-1.202
ND,Grant County,914,45138,33,2028,22,961,-11,-1.204
NE,Dakota County,7455,403580,695,27890,605,20409,-90,-1.207
IN,Randolph County,9269,433071,597,20168,485,16995,-112,-1.208
NM,Quay County,2712,98358,175,7123,142,4377,-33,-1.217
PA,Centre County,48004,3830859,3474,186506,2890,168523,-584,-1.217
TX,Mitchell County,2133,119487,169,7115,143,6830,-26,-1.219
AL,Bibb County,6054,332129,450,18686,376,15189,-74,-1.222
IA,Webster County,12817,795486,832,37730,675,27874,-157,-1.225
MA,Nantucket County,5544,615699,463,33271,395,35978,-68,-1.227
NC,Edgecombe County,16619,735148,1388,41270,1184,35183,-204,-1.228
IL,Christian County,12362,726261,678,29663,526,19655,-152,-1.23
MS,Walthall County,4388,195228,305,11414,251,10592,-54,-1.231
IL,Clark County,5924,359125,331,13878,258,11689,-73,-1.232
TX,Brazos County,59514,4454692,6443,322714,5709,329118,-734,-1.233
PA,Greene County,12651,938170,574,29631,418,18844,-156,-1.233
IN,Tippecanoe County,58397,4388178,5063,246847,4339,211874,-724,-1.24
IA,Tama County,6526,378592,459,20220,378,16397,-81,-1.241
GA,Worth County,6361,296012,457,15404,378,14025,-79,-1.242
AR,Drew County,5392,303798,429,16364,362,13851,-67,-1.243
CA,Sonoma County,194193,17219249,11194,829442,8772,701383,-2422,-1.247
MD,Montgomery County,405113,52588069,32326,2887619,27259,2063951,-5067,-1.251
IA,Franklin County,3594,217979,215,9273,170,6542,-45,-1.252
NC,Onslow County,54993,2720364,11873,493754,11183,472510,-690,-1.255
MT,Hill County,5809,324730,407,15751,334,13635,-73,-1.257
AL,Wilcox County,3335,130558,208,5975,166,5865,-42,-1.259
GA,Terrell County,2929,127622,222,6720,185,6893,-37,-1.263
TX,Lamb County,4025,174889,306,12980,255,9634,-51,-1.267
OK,Johnston County,3074,156084,280,10273,241,8888,-39,-1.269
KS,Labette County,7246,345331,478,18754,386,14604,-92,-1.27
KS,Edwards County,1102,58170,65,2632,51,1781,-14,-1.27
FL,Alachua County,85305,5952208,8912,445746,7827,399171,-1085,-1.272
CO,Pitkin County,7535,1117017,928,85488,832,181121,-96,-1.274
MT,Powder River County,628,30785,28,1407,20,578,-8,-1.274
SD,Oglala Lakota County,3138,106290,227,7303,187,4572,-40,-1.275
MS,Kemper County,2973,114923,181,6877,143,5132,-38,-1.278
NE,Stanton County,2106,118541,177,7398,150,6390,-27,-1.282
MS,Lawrence County,3822,189083,248,14081,199,6793,-49,-1.282
KY,Bell County,6776,274981,415,13351,328,9942,-87,-1.284
NE,Cedar County,3190,186478,161,8413,120,4493,-41,-1.285
MN,Grant County,2330,138025,160,9140,130,6754,-30,-1.288
MT,Blaine County,2017,85109,131,4874,105,3428,-26,-1.289
IN,Blackford County,4498,215717,321,11760,263,9278,-58,-1.289
KS,Cloud County,3168,153779,224,6649,183,7263,-41,-1.294
IA,Union County,4399,238774,289,13329,232,8571,-57,-1.296
CA,Santa Clara County,742126,137755940,51481,7270493,41828,4644312,-9653,-1.301
MN,Clearwater County,2994,200234,179,8039,140,5014,-39,-1.303
TX,San Patricio County,22691,1356899,2525,122067,2228,108487,-297,-1.309
NJ,Middlesex County,318211,29698095,24936,1989830,20753,1502853,-4183,-1.315
IA,Emmet County,3492,199848,222,8936,176,6187,-46,-1.317
AZ,Greenlee County,2575,159682,252,16302,218,10433,-34,-1.32
SD,Brown County,14790,1073272,1063,55558,867,37378,-196,-1.325
WV,Nicholas County,7999,392041,411,15927,305,15318,-106,-1.325
IL,Mason County,5093,281298,321,12095,253,8704,-68,-1.335
AR,Miller County,13161,709743,1330,50129,1154,42971,-176,-1.337
KY,Leslie County,2689,117014,112,3388,76,1899,-36,-1.339
CA,Modoc County,2679,132071,210,12508,174,7340,-36,-1.344
TX,Karnes County,4312,438073,330,15935,272,12567,-58,-1.345
NY,Rockland County,116136,12211778,6313,558226,4748,350327,-1565,-1.348
NE,Madison County,12897,829757,1006,44227,832,36484,-174,-1.349
MS,Attala County,5905,282668,290,11127,210,7680,-80,-1.355
OK,Latimer County,3025,149680,224,7790,183,6941,-41,-1.355
MO,Worth County,736,22460,38,1569,28,847,-10,-1.359
NE,Cuming County,3441,210229,198,8966,151,6148,-47,-1.366
IL,Lawrence County,4965,268903,314,12415,246,8240,-68,-1.37
WV,Clay County,2403,108254,138,5140,105,3377,-33,-1.373
NY,Tompkins County,32333,2576912,3192,175074,2748,146518,-444,-1.373
MN,Polk County,11390,742128,867,36296,710,32252,-157,-1.378
TX,Hansford County,1740,112664,97,4409,73,3707,-24,-1.379
WV,Tyler County,3039,202941,195,8067,153,5729,-42,-1.382
NE,Richardson County,3040,167749,152,5201,110,4430,-42,-1.382
VA,Fairfax County,418618,59342138,46195,4370226,40400,3516353,-5795,-1.384
OR,Benton County,29181,2504326,3675,189324,3271,169928,-404,-1.384
TX,Jim Hogg County,1587,66114,90,2626,68,2787,-22,-1.386
ND,Wells County,1656,108672,82,3631,59,2672,-23,-1.389
KS,Marion County,4244,233042,297,13779,238,10663,-59,-1.39
ND,Mountrail County,3234,314003,400,25739,355,18537,-45,-1.391
KS,Coffey County,3157,195485,203,13326,159,7573,-44,-1.394
MS,Claiborne County,2652,88601,165,5338,128,5350,-37,-1.395
KY,Breathitt County,3582,155271,153,5246,103,3918,-50,-1.396
SC,Allendale County,2507,94785,182,5197,147,3693,-35,-1.396
TX,Zapata County,4009,147756,164,7761,108,4047,-56,-1.397
VA,Prince Edward County,5988,311053,600,25360,516,21220,-84,-1.403
NC,Chowan County,4917,290296,335,16531,266,12002,-69,-1.403
TX,Lipscomb County,1068,70695,68,2778,53,1833,-15,-1.404
OK,Woodward County,6398,382561,449,22728,359,16694,-90,-1.407
KY,Harlan County,7028,290696,316,11089,217,5866,-99,-1.409
KS,Atchison County,5297,309414,413,18669,338,17282,-75,-1.416
NM,Hidalgo County,1411,57369,91,3414,71,3032,-20,-1.417
OK,Comanche County,34951,1874806,4286,190027,3790,162135,-496,-1.419
OK,Seminole County,6815,324826,614,21385,517,17207,-97,-1.423
KS,Finney County,13272,769669,1005,41280,816,30684,-189,-1.424
IN,Delaware County,37478,2058404,2665,108836,2131,81021,-534,-1.425
VA,Tazewell County,12445,681909,688,30489,510,22646,-178,-1.43
OK,Garfield County,20098,1389885,1736,98373,1448,73543,-288,-1.433
WY,Carbon County,5280,385692,511,30348,435,20870,-76,-1.439
AR,Nevada County,2569,111617,213,7568,176,5651,-37,-1.44
MO,Daviess County,2773,136143,187,7431,147,6258,-40,-1.442
KY,Todd County,3746,193550,268,9349,214,7458,-54,-1.442
NE,Dawson County,8861,469474,645,26583,517,19395,-128,-1.445
MO,Mississippi County,3738,172374,256,9262,202,6551,-54,-1.445
AL,Macon County,5737,247548,419,13670,336,11425,-83,-1.447
IA,Johnson County,49874,4380931,4919,289521,4194,228449,-725,-1.454
IL,McLean County,60405,5080026,4330,288116,3451,193448,-879,-1.455
AR,Pike County,3160,143112,216,7531,170,7251,-46,-1.456
OK,Greer County,1373,64285,87,2966,67,2733,-20,-1.457
IL,Massac County,5000,264743,289,10833,216,10162,-73,-1.46
MS,Tunica County,3488,117521,358,11094,307,7598,-51,-1.462
NE,Frontier County,888,33201,66,2410,53,1992,-13,-1.464
ND,LaMoure County,1636,98228,77,3432,53,2604,-24,-1.467
MO,Wayne County,3543,144021,289,8708,237,9863,-52,-1.468
NY,New York County,687496,179278891,78511,12473140,68408,8538560,-10103,-1.47
IL,Knox County,18650,1048871,1073,51669,798,34382,-275,-1.475
KS,Wichita County,813,50594,45,2072,33,1609,-12,-1.476
IL,Peoria County,68400,5294963,4839,387251,3825,190852,-1014,-1.482
IL,Coles County,16467,1011943,1233,55354,989,35483,-244,-1.482
NC,Washington County,3980,177001,229,7289,170,5782,-59,-1.482
AR,Monroe County,2213,85855,176,5430,143,5265,-33,-1.491
MS,Scott County,9028,392542,545,19350,409,13778,-136,-1.506
IL,Iroquois County,10777,618084,674,29368,511,23565,-163,-1.512
MS,Tallahatchie County,3899,147824,247,7241,188,5560,-59,-1.513
WI,Menominee County,1388,52786,111,3287,90,4067,-21,-1.513
MT,Richland County,4284,329684,347,21333,282,15933,-65,-1.517
GA,Clarke County,33925,2198885,4597,215571,4082,189358,-515,-1.518
KS,Mitchell County,2365,123098,120,5331,84,2875,-36,-1.522
IL,Schuyler County,2551,142299,159,5788,120,4709,-39,-1.529
NY,Kings County,974546,66066153,74783,5113184,59854,4126461,-14929,-1.532
NE,York County,5151,347798,366,17060,287,12563,-79,-1.534
MS,Quitman County,2144,72215,144,4102,111,3004,-33,-1.539
UT,Cache County,36658,2533221,3445,148506,2877,141912,-568,-1.549
TX,Hutchinson County,6830,441460,519,31785,413,19692,-106,-1.552
MS,Warren County,16308,896958,1004,46435,750,34560,-254,-1.558
AL,Perry County,2885,96506,172,4890,127,4553,-45,-1.56
MO,Buchanan County,30116,1758676,2191,107181,1721,68515,-470,-1.561
WA,Adams County,6395,335746,485,19957,385,14498,-100,-1.564
KS,Gray County,2105,123631,116,4485,83,4002,-33,-1.568
IN,Union County,2611,132093,208,6899,167,6645,-41,-1.57
AR,St. Francis County,6625,262310,519,18146,415,12020,-104,-1.57
TX,Hale County,10047,459936,783,27608,625,25234,-158,-1.573
MS,Noxubee County,3557,129812,179,6392,123,4128,-56,-1.574
ND,McLean County,3746,263659,270,14733,211,13102,-59,-1.575
ND,Stutsman County,8181,550847,536,27641,407,17169,-129,-1.577
MO,Dunklin County,8515,376672,594,18758,459,13374,-135,-1.585
OK,Nowata County,3216,164939,245,9004,194,7504,-51,-1.586
GA,Jeff Davis County,4019,205422,315,8884,251,8334,-64,-1.592
PA,Potter County,6152,318102,372,15526,274,10214,-98,-1.593
TX,Orange County,27022,1791638,2235,113878,1804,87181,-431,-1.595
MN,Nobles County,8049,453866,512,26410,383,15909,-129,-1.603
SD,Marshall County,1622,85134,97,3758,71,2673,-26,-1.603
MT,Meagher County,623,31917,43,2298,33,1114,-10,-1.605
SD,Beadle County,6707,404140,435,18464,327,12197,-108,-1.61
ND,Barnes County,4094,269819,262,12508,196,9173,-66,-1.612
MS,Leflore County,9218,393813,562,16516,413,13024,-149,-1.616
IA,Decatur County,2409,141820,193,7289,154,5682,-39,-1.619
WY,Sweetwater County,15417,1216231,1084,71652,834,43730,-250,-1.622
TX,Gray County,6530,368197,500,25917,394,15844,-106,-1.623
TX,Zavala County,3385,130321,218,6853,163,5546,-55,-1.625
IA,Page County,5164,296709,352,14494,268,12768,-84,-1.627
OK,Custer County,8391,560131,790,38870,653,30043,-137,-1.633
AL,Pike County,9484,527949,754,25969,599,20715,-155,-1.634
AR,Prairie County,2604,134426,173,6064,130,4795,-43,-1.651
KS,Ellis County,10140,641060,803,37243,635,24182,-168,-1.657
NE,Cherry County,2161,123624,140,4955,104,2836,-36,-1.666
AR,Lawrence County,4679,212488,405,12684,327,10112,-78,-1.667
NM,San Juan County,38069,2160798,2700,143240,2064,86206,-636,-1.671
KY,Letcher County,5715,258762,293,11274,197,7455,-96,-1.68
CO,Phillips County,1541,91989,109,4991,83,4060,-26,-1.687
NE,Wayne County,2901,195316,249,8760,200,8864,-49,-1.689
MS,Adams County,9528,494125,597,23099,435,15067,-162,-1.7
TX,Dawson County,3646,228302,256,12539,194,7722,-62,-1.7
KS,Brown County,3464,186095,217,11587,158,4427,-59,-1.703
KS,Crawford County,12277,765925,1003,35535,793,30388,-210,-1.711
KY,Magoffin County,3147,135847,170,5553,116,3675,-54,-1.716
KY,Lee County,1688,70385,111,4038,82,2196,-29,-1.718
NY,Queens County,929526,53963786,62452,3970563,46460,2597204,-15992,-1.72
MO,New Madrid County,5273,252820,491,18236,400,13846,-91,-1.726
GA,Tattnall County,5906,304294,498,18800,396,12728,-102,-1.727
GA,Glascock County,808,40933,56,1761,42,1712,-14,-1.733
IA,Adams County,1441,74421,94,3765,69,2696,-25,-1.735
SD,Charles Mix County,2882,164937,156,5512,106,3557,-50,-1.735
GA,Calhoun County,1495,63512,103,3194,77,2491,-26,-1.739
NM,Socorro County,5161,222285,391,13632,301,11220,-90,-1.744
IA,Winnebago County,4057,242816,318,13255,247,8904,-71,-1.75
GA,Stewart County,1199,46949,100,3196,79,2619,-21,-1.751
MS,Lauderdale County,24404,1433014,1675,83491,1247,54715,-428,-1.754
WV,Kanawha County,67398,4257704,3947,208542,2763,119029,-1184,-1.757
TX,Sutton County,1299,89405,86,6577,63,2930,-23,-1.771
IN,Monroe County,43347,3170977,4493,220268,3725,177125,-768,-1.772
ND,Towner County,903,56247,45,2074,29,968,-16,-1.772
IL,Calhoun County,1746,109610,96,3989,65,3110,-31,-1.775
TX,Ochiltree County,3149,225943,241,11527,185,7223,-56,-1.778
FL,Miami-Dade County,1030119,65044981,54277,3320025,35859,4309158,-18418,-1.788
OK,Jefferson County,1565,65519,136,4671,108,3655,-28,-1.789
MT,Dawson County,3184,193656,224,11311,167,6689,-57,-1.79
IA,Van Buren County,2511,133071,173,6285,128,6023,-45,-1.792
NV,Lander County,1840,143296,172,9332,139,6988,-33,-1.793
ND,Bottineau County,2559,168568,142,8993,96,5989,-46,-1.798
TX,Potter County,36969,2149711,4392,195398,3726,158867,-666,-1.802
IL,Gallatin County,1826,98577,85,2695,52,2119,-33,-1.807
TX,Deaf Smith County,5977,252104,394,15805,286,9839,-108,-1.807
CO,Conejos County,2374,100926,163,6645,120,4579,-43,-1.811
MO,Johnson County,16615,967856,2222,96511,1921,84551,-301,-1.812
MS,Forrest County,22508,1355203,2791,102561,2383,96000,-408,-1.813
MS,Clarke County,5172,259053,346,11671,252,9379,-94,-1.817
MI,Houghton County,11634,653731,857,35077,645,32070,-212,-1.822
OH,Athens County,17064,966687,1530,59553,1218,47825,-312,-1.828
SD,Brookings County,10931,811136,1029,47662,829,37319,-200,-1.83
SD,Dewey County,1855,82350,107,2836,73,2001,-34,-1.833
TX,Parmer County,3036,137498,257,12174,201,7999,-56,-1.845
MI,Isabella County,20140,1214536,2010,81350,1638,65219,-372,-1.847
IL,Morgan County,12485,753863,824,37687,593,23176,-231,-1.85
TX,Yoakum County,2699,195927,204,11190,154,7012,-50,-1.853
IL,Cumberland County,3915,221867,268,10906,195,8469,-73,-1.865
AR,Jefferson County,21975,1067500,1476,55257,1060,35826,-416,-1.893
KY,Martin County,2430,84168,131,5470,85,3203,-46,-1.893
KY,Knott County,3840,173682,214,6990,141,4545,-73,-1.901
TX,Crosby County,1788,83243,167,6708,133,5668,-34,-1.902
AL,Conecuh County,3644,163575,252,8281,182,6471,-70,-1.921
MS,Sunflower County,7485,301855,500,12877,356,10083,-144,-1.924
KY,Crittenden County,2849,147650,179,5951,124,4940,-55,-1.931
NC,Lenoir County,18388,882752,1395,51823,1037,34998,-358,-1.947
TX,Jefferson County,80321,5101698,5995,321674,4427,215584,-1568,-1.952
KS,Barton County,9564,532381,584,29052,397,18273,-187,-1.955
SD,Buffalo County,459,12765,35,778,26,561,-9,-1.961
TX,Stonewall County,458,31881,36,1324,27,1292,-9,-1.965
NE,Phelps County,3386,227335,258,12098,191,8005,-67,-1.979
MS,Hinds County,79978,4173791,5934,273387,4351,182171,-1583,-1.979
NE,Custer County,4113,199434,255,10365,173,7567,-82,-1.994
MT,Custer County,4260,262099,312,12699,227,9424,-85,-1.995
WV,Mingo County,6228,283154,353,12740,228,6663,-125,-2.007
NE,Dixon County,2142,117432,141,6260,98,4455,-43,-2.007
SD,Brule County,1888,119332,127,4481,89,3561,-38,-2.013
ND,Emmons County,1335,67843,57,2769,30,1557,-27,-2.022
TX,McMullen County,295,34323,32,1398,26,1263,-6,-2.034
NE,Sheridan County,1858,78689,128,7694,90,3352,-38,-2.045
KS,Chautauqua County,1069,53070,64,2905,42,1993,-22,-2.058
SD,Ziebach County,388,14828,28,720,20,298,-8,-2.062
ND,McHenry County,2179,125427,125,6160,80,4406,-45,-2.065
MO,Putnam County,1597,69918,109,4782,76,3793,-33,-2.066
SD,Sully County,578,35173,32,1351,20,1061,-12,-2.076
MO,Phelps County,13487,769105,1294,51466,1014,42411,-280,-2.076
KS,Osborne County,1443,64893,73,2546,43,1589,-30,-2.079
ND,Pembina County,2788,190407,177,10290,119,5723,-58,-2.08
TX,Refugio County,2348,117758,215,9476,166,7988,-49,-2.087
WV,McDowell County,4311,177479,256,8463,166,5334,-90,-2.088
ND,Benson County,1912,94684,111,2637,71,2329,-40,-2.092
OK,Jackson County,7776,430049,944,46340,781,34548,-163,-2.096
AR,Desha County,3718,157469,281,9334,203,6245,-78,-2.098
NE,Adams County,11325,757317,867,43608,628,26390,-239,-2.11
WV,Cabell County,30518,1880712,2488,118067,1839,72949,-649,-2.127
MT,Rosebud County,2915,179246,234,11268,172,8796,-62,-2.127
MS,Humphreys County,2581,96740,166,4885,111,2974,-55,-2.131
OR,Wheeler County,422,16241,38,1398,29,1399,-9,-2.133
TX,Castro County,2157,82218,175,7015,129,5354,-46,-2.133
NY,Bronx County,516670,22250326,35641,1583505,24562,1036370,-11079,-2.144
AR,Cross County,5448,264078,393,14888,276,11718,-117,-2.148
VA,Montgomery County,26748,2006142,3091,152445,2515,133772,-576,-2.153
MS,Bolivar County,10302,500088,687,26584,465,14925,-222,-2.155
MS,Jefferson County,2457,84514,166,5462,113,3660,-53,-2.157
MS,Oktibbeha County,13387,809827,1550,76504,1261,58698,-289,-2.159
ND,Grand Forks County,24910,1894823,2719,137084,2181,99940,-538,-2.16
MO,Atchison County,2036,118898,118,4343,74,2629,-44,-2.161
TX,Jeff Davis County,784,52158,61,2850,44,2434,-17,-2.168
NM,McKinley County,24005,907011,1826,63557,1305,41820,-521,-2.17
FL,Monroe County,31459,3623549,4183,299772,3500,408486,-683,-2.171
FL,Bay County,63483,3659030,7109,405104,5727,320155,-1382,-2.177
CA,Butte County,72701,4697236,6247,304738,4652,235372,-1595,-2.194
NY,Jefferson County,38043,2146427,5250,240411,4415,191937,-835,-2.195
MS,Washington County,15183,659106,951,35773,617,17344,-334,-2.2
MO,Nodaway County,6765,374290,534,21166,385,14380,-149,-2.203
ND,Mercer County,3216,269429,245,15576,174,12573,-71,-2.208
GA,Clay County,903,29950,62,1789,42,2192,-20,-2.215
TX,Kleberg County,9586,512318,1033,45748,820,35130,-213,-2.222
NM,Curry County,15162,732681,1969,94154,1631,65979,-338,-2.229
MS,Sharkey County,1434,54809,96,3305,64,2852,-32,-2.232
MO,Grundy County,3314,160886,207,8308,133,6276,-74,-2.233
OK,Major County,2574,175714,172,9129,114,6100,-58,-2.253
IA,Pocahontas County,2645,152709,194,7460,134,5902,-60,-2.268
GA,Dougherty County,26932,1236208,2565,97520,1953,69041,-612,-2.272
MN,Lyon County,9316,650090,719,34391,507,21360,-212,-2.276
IA,Buena Vista County,7500,478745,635,25487,464,17437,-171,-2.28
IL,Pulaski County,1862,84350,134,4615,91,2789,-43,-2.309
NE,Sherman County,1167,46212,86,2903,59,2403,-27,-2.314
IA,Story County,28254,2344935,3146,151846,2492,123332,-654,-2.315
OK,Alfalfa County,1543,113936,108,5559,72,3299,-36,-2.333
IL,McDonough County,9349,548738,799,26564,579,20309,-220,-2.353
MA,Suffolk County,287808,33868728,37812,3362013,31005,3242481,-6807,-2.365
TX,Sterling County,421,35488,38,1913,28,1130,-10,-2.375
ND,Rolette County,4000,197822,218,6801,123,5153,-95,-2.375
SD,Kingsbury County,2010,120501,127,5715,79,3905,-48,-2.388
IL,Champaign County,67352,4923946,5860,302673,4250,210441,-1610,-2.39
ND,Cavalier County,1576,113973,76,3449,38,2120,-38,-2.411
KS,Scott County,1817,129737,128,5676,84,4209,-44,-2.422
TX,Brewster County,3262,213295,404,22217,325,17486,-79,-2.422
MT,Toole County,1680,85198,135,5006,94,4561,-41,-2.44
TX,Childress County,1838,95339,145,6611,100,4072,-45,-2.448
TX,Walker County,17453,953091,2224,86473,1796,80047,-428,-2.452
TX,Donley County,1014,47242,84,4061,59,2721,-25,-2.465
GA,Baker County,892,33962,70,1628,48,1553,-22,-2.466
TX,Armstrong County,648,38360,54,2743,38,2159,-16,-2.469
AR,Mississippi County,12510,609009,899,35899,590,20854,-309,-2.47
KS,Hamilton County,809,16825,44,1642,24,946,-20,-2.472
GA,Liberty County,17565,782409,4571,169293,4134,150540,-437,-2.488
KS,Chase County,957,47049,57,1921,33,1805,-24,-2.508
SD,Lake County,5041,375364,720,47661,593,39201,-127,-2.519
WV,Doddridge County,2258,140938,156,6571,99,4681,-57,-2.524
TX,Willacy County,5836,214958,373,13371,225,7543,-148,-2.536
TX,Bailey County,1970,95476,168,11123,118,5051,-50,-2.538
SD,Sanborn County,903,47248,52,2373,29,1090,-23,-2.547
IL,Greene County,4602,232657,301,14186,183,7155,-118,-2.564
SD,Aurora County,1046,50910,67,2474,40,1774,-27,-2.581
VA,Arlington County,90095,13138782,18527,1989247,16200,1383220,-2327,-2.583
IL,Pope County,1269,61789,98,3572,65,2876,-33,-2.6
PA,Montour County,6921,578246,786,54278,606,39726,-180,-2.601
KY,Cumberland County,2067,81875,104,2988,50,1652,-54,-2.612
TN,Lake County,1626,65861,125,4670,82,2986,-43,-2.645
SD,Perkins County,1125,58261,51,1762,21,543,-30,-2.667
WY,Albany County,11802,781610,1637,68137,1322,62963,-315,-2.669
MS,Coahoma County,7277,292403,472,14263,277,8831,-195,-2.68
KS,Kearny County,1380,79269,101,5179,64,2532,-37,-2.681
TX,Cochran County,857,42972,73,3808,50,1690,-23,-2.684
AL,Dallas County,12346,517964,728,29459,396,13982,-332,-2.689
SD,Hand County,1287,76682,66,3116,31,1367,-35,-2.72
IL,Jackson County,17009,1047522,1868,71563,1403,46889,-465,-2.734
TX,Throckmorton County,475,27459,48,1713,35,1373,-13,-2.737
KS,Stevens County,1717,109893,105,4653,57,2398,-48,-2.796
AR,Phillips County,5377,206829,346,10854,195,9783,-151,-2.808
KS,Geary County,10922,526144,3663,146485,3356,128843,-307,-2.811
SD,Edmunds County,1382,104409,100,4824,61,2553,-39,-2.822
SD,Clay County,3874,257087,564,24143,451,19630,-113,-2.917
KS,Pawnee County,2209,111833,152,5766,87,2972,-65,-2.943
MT,McCone County,709,30518,20,666,-1,-1,-21,-2.962
WA,Whitman County,12608,864631,1911,81609,1535,68066,-376,-2.982
MN,Norman County,2509,148302,175,7673,99,4467,-76,-3.029
OK,Payne County,21847,1416647,2652,114496,1989,86263,-663,-3.035
NM,Union County,1215,51922,102,3718,65,2467,-37,-3.045
NM,Roosevelt County,5468,235593,678,23355,510,17951,-168,-3.072
ND,Sioux County,960,32759,80,2764,50,1698,-30,-3.125
TX,Motley County,384,15683,39,1537,27,1304,-12,-3.125
KS,Grant County,2406,144505,196,9047,120,3973,-76,-3.159
TX,Schleicher County,869,51942,76,3803,48,1893,-28,-3.222
TX,Moore County,7034,356653,740,33485,513,18550,-227,-3.227
KS,Pratt County,3312,204094,310,12602,203,8412,-107,-3.231
TX,Hemphill County,1242,94991,89,4733,48,2410,-41,-3.301
KS,Ford County,11694,630707,966,40099,579,22318,-387,-3.309
KS,Morton County,1015,62347,84,3284,50,2069,-34,-3.35
KS,Haskell County,1337,81499,97,5163,51,2109,-46,-3.441
IL,Cass County,4857,257327,384,15316,215,7962,-169,-3.48
ND,Divide County,908,61923,56,3263,24,1238,-32,-3.524
ND,Ward County,25192,1800962,3445,175262,2555,118472,-890,-3.533
NE,Dawes County,2735,139691,267,9862,170,7005,-97,-3.547
IL,Alexander County,1881,79875,168,4822,101,2619,-67,-3.562
SD,Campbell County,585,31215,20,1294,-1,-1,-21,-3.59
KS,Riley County,17885,1247928,3693,165529,3038,131431,-655,-3.662
TX,Presidio County,2646,124868,244,10915,147,7088,-97,-3.666
OK,Woods County,2811,191383,250,11321,145,6406,-105,-3.735
MO,Scotland County,1583,70482,134,4895,72,2724,-62,-3.917
MO,Pemiscot County,4685,215990,395,13055,209,5713,-186,-3.97
WY,Niobrara County,863,48165,56,3282,20,892,-36,-4.171
WY,Hot Springs County,1666,86969,165,7176,94,4089,-71,-4.262
KS,Seward County,7271,370701,694,29721,384,13756,-310,-4.264
OK,Texas County,7120,372603,730,28832,422,14642,-308,-4.326
KS,Phillips County,2095,98592,150,5897,59,2057,-91,-4.344
TX,Dallam County,2411,125326,315,13037,206,9571,-109,-4.521
TX,Aransas County,7444,475260,1341,65855,963,59823,-378,-5.078
MT,Garfield County,406,20403,20,228,-1,-1,-21,-5.172
NE,Cheyenne County,3426,279485,465,72584,287,13011,-178,-5.196
CO,Cheyenne County,635,26767,33,1052,-1,-1,-34,-5.354
GA,Chattahoochee County,1699,73400,1110,49507,1011,41426,-99,-5.827
KS,Greeley County,482,26103,31,1638,-1,-1,-32,-6.639
ND,Adams County,952,53763,64,3626,-1,-1,-65,-6.828
ND,Billings County,366,32302,26,1697,-1,-1,-27,-7.377
CA,Alpine County,336,21089,49,1595,23,1877,-26,-7.738
ID,Madison County,8363,466480,2114,65741,1448,53351,-666,-7.964
TX,Terrell County,259,13742,21,1616,-1,-1,-22,-8.494
NE,Wheeler County,304,13276,26,915,-1,-1,-27,-8.882
MS,Issaquena County,324,14057,28,1600,-1,-1,-29,-8.951
NE,Thomas County,245,11253,23,894,-1,-1,-24,-9.796
TX,Borden County,210,19915,20,1114,-1,-1,-21,-10.0
TX,Roberts County,275,17228,29,2415,-1,-1,-30,-10.909
MT,Treasure County,274,14096,31,1657,-1,-1,-32,-11.679
NE,Logan County,253,11987,29,1271,-1,-1,-30,-11.858
TX,Kent County,252,16917,30,1474,-1,-1,-31,-12.302
UT,Daggett County,309,17658,46,2128,-1,-1,-47,-15.21
